Date,Hour,NUCLEAR,GAS,HYDRO,WIND,SOLAR,BIOFUEL,Total Output
2023-01-01,1,9977,130,4185,533,0,19,14844
2023-01-01,2,9993,130,3928,688,0,19,14758
2023-01-01,3,9996,129,3725,693,0,19,14562
2023-01-01,4,9999,129,3860,685,0,19,14692
2023-01-01,5,10002,152,3826,658,0,19,14657
2023-01-01,6,10000,238,3680,710,0,19,14647
2023-01-01,7,10007,573,3964,592,0,19,15155
2023-01-01,8,10002,975,3670,508,0,24,15179
2023-01-01,9,10003,1252,3979,499,7,27,15767
2023-01-01,10,10006,1412,4008,728,29,27,16210
2023-01-01,11,10004,1715,4263,739,35,28,16784
2023-01-01,12,10004,1906,4675,859,51,28,17523
2023-01-01,13,10005,1977,4733,622,46,27,17410
2023-01-01,14,10005,1804,4845,624,50,26,17354
2023-01-01,15,9999,1246,4893,649,29,27,16843
2023-01-01,16,10002,1280,5008,527,13,27,16857
2023-01-01,17,9998,1657,5193,633,0,27,17508
2023-01-01,18,10004,2000,5297,790,0,27,18118
2023-01-01,19,10004,1993,5048,1034,0,31,18110
2023-01-01,20,10002,1486,4775,1166,0,30,17459
2023-01-01,21,9999,1220,4737,1260,0,31,17247
2023-01-01,22,10002,1166,4258,1254,0,31,16711
2023-01-01,23,10007,837,4178,1359,0,31,16412
2023-01-01,24,9999,372,3860,1361,0,20,15612
2023-01-02,1,10009,131,3804,1451,0,19,15414
2023-01-02,2,10016,131,3419,1536,0,19,15121
2023-01-02,3,10031,130,3676,1226,0,19,15082
2023-01-02,4,10027,309,3862,1075,0,19,15292
2023-01-02,5,10025,839,3340,854,0,19,15077
2023-01-02,6,10014,1484,3243,606,0,19,15366
2023-01-02,7,10017,1856,3417,501,0,24,15815
2023-01-02,8,10016,2101,3730,297,0,30,16174
2023-01-02,9,10013,2158,3995,342,6,30,16544
2023-01-02,10,10010,2162,4778,327,32,30,17339
2023-01-02,11,10011,2162,5076,269,68,30,17616
2023-01-02,12,10013,2151,5042,198,111,30,17545
2023-01-02,13,10009,2208,4444,184,214,30,17089
2023-01-02,14,10011,2253,4904,184,134,30,17516
2023-01-02,15,10017,2197,5514,159,113,30,18030
2023-01-02,16,10025,2246,5497,154,50,30,18002
2023-01-02,17,10025,2595,5896,164,10,30,18720
2023-01-02,18,10026,2887,6007,224,0,31,19175
2023-01-02,19,10025,2867,6025,335,0,31,19283
2023-01-02,20,10028,2721,5990,335,0,31,19105
2023-01-02,21,10026,1854,5697,528,0,31,18136
2023-01-02,22,10024,1240,5188,729,0,31,17212
2023-01-02,23,10025,754,4842,917,0,30,16568
2023-01-02,24,10029,568,4470,900,0,21,15988
2023-01-03,1,10027,655,4483,881,0,19,16065
2023-01-03,2,10026,696,4318,1061,0,19,16120
2023-01-03,3,10026,564,3944,1305,0,19,15858
2023-01-03,4,10032,547,3889,1104,0,19,15591
2023-01-03,5,10028,754,3975,1125,0,19,15901
2023-01-03,6,10025,1323,3527,1191,0,19,16085
2023-01-03,7,10030,1935,3867,1338,0,24,17194
2023-01-03,8,10028,2126,4023,1243,0,30,17450
2023-01-03,9,10024,2133,4393,1574,6,31,18161
2023-01-03,10,10026,2155,4514,1685,13,31,18424
2023-01-03,11,10031,2390,5206,1604,20,31,19282
2023-01-03,12,10020,2553,5167,1666,27,31,19464
2023-01-03,13,10022,2578,4886,1755,36,31,19308
2023-01-03,14,10022,2589,5235,1513,32,31,19422
2023-01-03,15,10022,2886,5401,1361,26,31,19727
2023-01-03,16,10021,2875,5198,1268,12,31,19405
2023-01-03,17,10031,2833,5259,1224,0,31,19378
2023-01-03,18,10027,2803,5985,1384,0,31,20230
2023-01-03,19,10032,2324,6022,1372,0,30,19780
2023-01-03,20,10034,2195,5538,1261,0,30,19058
2023-01-03,21,10030,1901,5233,1139,0,30,18333
2023-01-03,22,10028,1450,5184,1108,0,28,17798
2023-01-03,23,10034,488,5067,1154,0,30,16773
2023-01-03,24,10028,258,5129,916,0,20,16351
2023-01-04,1,10029,462,4690,873,0,19,16073
2023-01-04,2,10029,584,4055,1120,0,19,15807
2023-01-04,3,10029,554,4069,1180,0,19,15851
2023-01-04,4,10032,566,4141,1279,0,19,16037
2023-01-04,5,10030,679,4203,1319,0,19,16250
2023-01-04,6,10036,1008,4014,1204,0,19,16281
2023-01-04,7,10033,1254,4072,1370,0,19,16748
2023-01-04,8,10039,1654,3943,1515,0,23,17174
2023-01-04,9,10009,1861,4008,1556,6,30,17470
2023-01-04,10,9971,1935,4728,1546,17,30,18227
2023-01-04,11,9926,2418,4912,1607,29,30,18922
2023-01-04,12,9818,2607,4934,1593,27,30,19009
2023-01-04,13,9895,2580,5154,1533,38,30,19230
2023-01-04,14,10015,2444,5227,1538,57,30,19311
2023-01-04,15,10019,2403,5359,1737,48,30,19596
2023-01-04,16,10017,2165,5273,1670,27,30,19182
2023-01-04,17,10015,2079,5656,1895,4,30,19679
2023-01-04,18,10018,2323,5810,1855,0,30,20036
2023-01-04,19,10026,2110,5716,2013,0,30,19895
2023-01-04,20,10029,1951,5746,2320,0,30,20076
2023-01-04,21,10030,1972,5508,2536,0,30,20076
2023-01-04,22,10033,1339,5333,2562,0,30,19297
2023-01-04,23,10030,945,5081,2455,0,30,18541
2023-01-04,24,10029,368,4509,2540,0,22,17468
2023-01-05,1,10032,133,4065,2601,0,19,16850
2023-01-05,2,10032,132,3857,2765,0,19,16805
2023-01-05,3,10036,132,3715,2826,0,19,16728
2023-01-05,4,10037,243,3825,2599,0,19,16723
2023-01-05,5,10035,452,4030,2246,0,19,16782
2023-01-05,6,10034,806,3793,1818,0,19,16470
2023-01-05,7,10041,1066,4168,1610,0,19,16904
2023-01-05,8,10038,1459,5111,1529,0,24,18161
2023-01-05,9,10037,1753,5471,1547,11,30,18849
2023-01-05,10,10034,1923,5231,1569,28,30,18815
2023-01-05,11,9519,2453,5802,1515,53,30,19372
2023-01-05,12,8978,3520,5601,1415,63,30,19607
2023-01-05,13,8974,3760,5326,1235,88,30,19413
2023-01-05,14,8977,3869,5411,1096,73,30,19456
2023-01-05,15,8977,3328,5484,925,57,30,18801
2023-01-05,16,8976,3471,5864,694,23,30,19058
2023-01-05,17,8973,3963,5907,751,4,30,19628
2023-01-05,18,8980,4121,5931,658,0,30,19720
2023-01-05,19,8982,3963,5942,836,0,29,19752
2023-01-05,20,8982,3555,5886,937,0,26,19386
2023-01-05,21,8981,3497,5781,857,0,31,19147
2023-01-05,22,8983,2516,5495,806,0,33,17833
2023-01-05,23,8984,2410,4960,705,0,32,17091
2023-01-05,24,8981,1939,4768,694,0,24,16406
2023-01-06,1,8980,1848,4415,678,0,20,15941
2023-01-06,2,8985,1842,3980,729,0,20,15556
2023-01-06,3,8987,2272,3919,754,0,20,15952
2023-01-06,4,8981,2636,3890,720,0,20,16247
2023-01-06,5,8978,2388,3538,734,0,20,15658
2023-01-06,6,8983,2552,3618,734,0,20,15907
2023-01-06,7,8988,3048,4606,757,0,22,17421
2023-01-06,8,8984,3643,4874,926,0,46,18473
2023-01-06,9,8981,4143,4892,968,8,64,19056
2023-01-06,10,8984,4512,4959,912,33,55,19455
2023-01-06,11,9024,4236,4929,834,96,63,19182
2023-01-06,12,9060,4391,4929,741,92,67,19280
2023-01-06,13,9067,4336,4967,629,84,67,19150
2023-01-06,14,9068,4128,4950,846,67,65,19124
2023-01-06,15,9069,3863,5037,941,57,67,19034
2023-01-06,16,9066,4014,5562,875,28,66,19611
2023-01-06,17,9068,4236,5858,861,4,64,20091
2023-01-06,18,9069,4394,5829,941,0,63,20296
2023-01-06,19,9072,4148,5846,866,0,61,19993
2023-01-06,20,9070,3607,5718,803,0,63,19261
2023-01-06,21,9068,3465,5489,778,0,58,18858
2023-01-06,22,9053,3234,4947,836,0,42,18112
2023-01-06,23,9070,2663,4827,649,0,50,17259
2023-01-06,24,9066,2199,4616,731,0,46,16658
2023-01-07,1,9073,1364,4260,720,0,46,15463
2023-01-07,2,9072,1002,4216,713,0,42,15045
2023-01-07,3,9071,776,4321,694,0,40,14902
2023-01-07,4,9074,758,4143,604,0,39,14618
2023-01-07,5,9072,1034,4197,588,0,40,14931
2023-01-07,6,9067,1205,3991,569,0,38,14870
2023-01-07,7,9068,1669,4040,616,0,45,15438
2023-01-07,8,9067,2124,4145,559,0,48,15943
2023-01-07,9,9067,2170,4579,677,4,45,16542
2023-01-07,10,9060,2465,4743,716,21,36,17041
2023-01-07,11,9063,2814,4731,727,45,38,17418
2023-01-07,12,9058,2897,4635,873,119,44,17626
2023-01-07,13,9061,2806,4687,948,162,44,17708
2023-01-07,14,9057,2617,4799,1007,162,39,17681
2023-01-07,15,9068,2443,5022,790,120,33,17476
2023-01-07,16,9103,2524,5328,565,58,30,17608
2023-01-07,17,9226,2863,5805,456,7,32,18389
2023-01-07,18,9242,3303,5703,433,0,30,18711
2023-01-07,19,9242,3289,5690,448,0,32,18701
2023-01-07,20,9253,3094,5617,491,0,32,18487
2023-01-07,21,9243,3052,5483,338,0,32,18148
2023-01-07,22,9243,2928,5270,261,0,31,17733
2023-01-07,23,9243,2767,4860,215,0,31,17116
2023-01-07,24,9243,2168,4564,169,0,23,16167
2023-01-08,1,9241,1831,4463,180,0,21,15736
2023-01-08,2,9241,1710,4368,116,0,21,15456
2023-01-08,3,9236,1842,4272,124,0,21,15495
2023-01-08,4,9232,2064,4230,128,0,21,15675
2023-01-08,5,9239,1861,4152,147,0,21,15420
2023-01-08,6,9238,1983,3816,160,0,21,15218
2023-01-08,7,9246,2121,4380,143,0,26,15916
2023-01-08,8,9245,2197,4507,173,0,30,16152
2023-01-08,9,9247,2339,4884,235,28,30,16763
2023-01-08,10,9245,2517,5094,257,88,30,17231
2023-01-08,11,9241,2878,5375,213,71,30,17808
2023-01-08,12,9243,3543,5370,225,80,30,18491
2023-01-08,13,9244,3119,5255,272,91,36,18017
2023-01-08,14,9244,2754,5103,323,71,53,17548
2023-01-08,15,9168,2620,5204,282,29,60,17363
2023-01-08,16,9257,2765,5571,212,12,50,17867
2023-01-08,17,9270,3335,5883,175,3,47,18713
2023-01-08,18,9270,3921,5843,180,0,53,19267
2023-01-08,19,9273,3747,5875,214,0,46,19155
2023-01-08,20,9277,3565,5843,270,0,34,18989
2023-01-08,21,9267,3291,5511,297,0,34,18400
2023-01-08,22,9270,3032,5084,301,0,34,17721
2023-01-08,23,9280,2166,4801,509,0,34,16790
2023-01-08,24,9299,1071,4597,696,0,25,15688
2023-01-09,1,9364,579,3763,857,0,22,14585
2023-01-09,2,9426,550,3627,1055,0,22,14680
2023-01-09,3,9451,647,3706,1139,0,22,14965
2023-01-09,4,9476,632,3932,1175,0,22,15237
2023-01-09,5,9558,1090,3586,1326,0,22,15582
2023-01-09,6,9630,1739,3404,1549,0,22,16344
2023-01-09,7,9669,2221,3993,1852,0,28,17763
2023-01-09,8,9689,2519,5272,2087,0,33,19600
2023-01-09,9,9748,2507,5301,2274,10,33,19873
2023-01-09,10,9769,2395,5007,2658,29,33,19891
2023-01-09,11,9783,2368,4599,2616,114,32,19512
2023-01-09,12,9791,2366,4026,2799,147,31,19160
2023-01-09,13,9791,2196,3889,2648,151,31,18706
2023-01-09,14,9788,2186,3923,3083,110,32,19122
2023-01-09,15,9789,1842,4230,2446,70,32,18409
2023-01-09,16,9808,1963,4426,2923,35,32,19187
2023-01-09,17,9918,2513,5048,2696,8,45,20228
2023-01-09,18,10065,2787,5868,2353,0,72,21145
2023-01-09,19,10148,2759,5710,2358,0,82,21057
2023-01-09,20,10151,2750,5141,2081,0,82,20205
2023-01-09,21,10154,1995,5330,1724,0,82,19285
2023-01-09,22,10152,1585,5018,1495,0,82,18332
2023-01-09,23,9900,1263,4813,1288,0,44,17308
2023-01-09,24,9886,771,4488,1033,0,25,16203
2023-01-10,1,9886,536,4537,799,0,21,15779
2023-01-10,2,9885,617,4004,640,0,21,15167
2023-01-10,3,9886,935,4010,523,0,21,15375
2023-01-10,4,9888,1399,3981,484,0,21,15773
2023-01-10,5,9888,1824,3902,351,0,21,15986
2023-01-10,6,9828,2008,4366,250,0,30,16482
2023-01-10,7,9920,2448,4933,226,0,70,17597
2023-01-10,8,9928,3155,5464,251,0,84,18882
2023-01-10,9,9928,3404,5513,282,3,85,19215
2023-01-10,10,9931,2555,5404,362,32,84,18368
2023-01-10,11,9937,2576,5559,318,118,84,18592
2023-01-10,12,9997,2534,5465,286,194,87,18563
2023-01-10,13,10045,2299,5465,270,224,105,18408
2023-01-10,14,10037,2289,5356,274,199,103,18258
2023-01-10,15,9941,2386,5441,317,145,104,18334
2023-01-10,16,9833,2953,5829,361,61,100,19137
2023-01-10,17,9880,3820,5852,454,8,101,20115
2023-01-10,18,9993,4186,5788,647,0,103,20717
2023-01-10,19,10025,4146,5933,662,0,108,20874
2023-01-10,20,10028,3896,5933,816,0,110,20783
2023-01-10,21,10020,3335,5755,1162,0,106,20378
2023-01-10,22,10028,2842,5251,1581,0,108,19810
2023-01-10,23,10026,2308,4914,1776,0,69,19093
2023-01-10,24,10018,1583,4349,1902,0,49,17901
2023-01-11,1,10023,991,4176,2088,0,46,17324
2023-01-11,2,10019,725,3997,2183,0,47,16971
2023-01-11,3,10023,802,4055,1902,0,47,16829
2023-01-11,4,10031,1029,4435,1772,0,47,17314
2023-01-11,5,10031,1540,4455,1873,0,48,17947
2023-01-11,6,10034,1921,4353,2168,0,58,18534
2023-01-11,7,10036,2547,4547,2208,0,102,19440
2023-01-11,8,10032,3257,5474,2386,0,111,21260
2023-01-11,9,10024,3845,5326,2308,28,115,21646
2023-01-11,10,10022,3748,5286,2096,92,110,21354
2023-01-11,11,10019,3768,5227,1762,172,115,21063
2023-01-11,12,10017,3881,5191,1435,186,113,20823
2023-01-11,13,9980,4329,5220,1119,156,119,20923
2023-01-11,14,9978,3696,5082,1147,96,115,20114
2023-01-11,15,9980,3042,5214,1306,53,117,19712
2023-01-11,16,9975,3434,5648,1328,28,116,20529
2023-01-11,17,9977,3184,5772,1605,5,122,20665
2023-01-11,18,9974,3086,5746,2002,0,130,20938
2023-01-11,19,9975,3113,5678,2127,0,128,21021
2023-01-11,20,9980,3185,5644,2275,0,127,21211
2023-01-11,21,9976,3603,5435,2294,0,125,21433
2023-01-11,22,9975,3143,5053,2151,0,77,20399
2023-01-11,23,9979,2207,4910,1896,0,58,19050
2023-01-11,24,9978,1542,4773,1650,0,47,17990
2023-01-12,1,9982,872,4477,1582,0,41,16954
2023-01-12,2,9987,753,4208,1492,0,42,16482
2023-01-12,3,9992,753,4080,1610,0,39,16474
2023-01-12,4,9993,861,3473,1209,0,35,15571
2023-01-12,5,9994,1096,3845,1084,0,35,16054
2023-01-12,6,9925,1528,4514,687,0,64,16718
2023-01-12,7,9900,2248,5358,534,0,96,18136
2023-01-12,8,9902,3295,5698,664,0,110,19669
2023-01-12,9,9900,3565,5589,789,0,115,19958
2023-01-12,10,9901,3234,5406,788,11,113,19453
2023-01-12,11,9949,3217,5376,709,19,112,19382
2023-01-12,12,9985,3719,5298,721,26,113,19862
2023-01-12,13,9903,3747,5118,765,26,117,19676
2023-01-12,14,9847,3479,5087,1223,22,127,19785
2023-01-12,15,9843,2810,4876,1671,13,126,19339
2023-01-12,16,9848,2673,4739,2110,6,129,19505
2023-01-12,17,9846,2679,5253,2449,0,125,20352
2023-01-12,18,9847,2691,5232,2908,0,125,20803
2023-01-12,19,9855,2310,4797,2969,0,122,20053
2023-01-12,20,9853,1752,5099,3072,0,121,19897
2023-01-12,21,9851,829,5144,3228,0,122,19174
2023-01-12,22,9852,510,4677,3483,0,80,18602
2023-01-12,23,9849,199,4351,3514,0,69,17982
2023-01-12,24,9851,128,3996,3519,0,51,17545
2023-01-13,1,9848,127,3751,3512,0,51,17289
2023-01-13,2,9847,128,3768,3628,0,49,17420
2023-01-13,3,9567,128,4242,3688,0,50,17675
2023-01-13,4,9505,313,4357,3699,0,49,17923
2023-01-13,5,9511,723,4235,3630,0,51,18150
2023-01-13,6,9500,1225,3914,3516,0,49,18204
2023-01-13,7,9491,1541,4142,3328,0,49,18551
2023-01-13,8,9492,1590,4644,3364,0,58,19148
2023-01-13,9,9491,1608,5350,3321,0,62,19832
2023-01-13,10,9490,1731,5267,3199,4,49,19740
2023-01-13,11,9491,1702,5291,3217,13,51,19765
2023-01-13,12,9491,1599,5238,3201,27,43,19599
2023-01-13,13,9511,1621,5157,3110,32,43,19474
2023-01-13,14,9509,1773,5035,3101,33,45,19496
2023-01-13,15,9506,1771,4999,3041,28,50,19395
2023-01-13,16,9508,1771,5017,3075,16,81,19468
2023-01-13,17,9511,1769,5319,3140,3,87,19829
2023-01-13,18,9501,1782,5740,3099,0,78,20200
2023-01-13,19,9513,1781,5663,3068,0,83,20108
2023-01-13,20,9515,1759,5494,2967,0,87,19822
2023-01-13,21,9516,1630,5344,2913,0,81,19484
2023-01-13,22,9510,1217,5075,2854,0,40,18696
2023-01-13,23,9516,853,4740,2631,0,26,17766
2023-01-13,24,9517,400,4526,2507,0,19,16969
2023-01-14,1,9510,344,4240,2587,0,20,16701
2023-01-14,2,9516,315,4001,2449,0,21,16302
2023-01-14,3,9519,316,4044,2223,0,21,16123
2023-01-14,4,9525,316,4242,2005,0,21,16109
2023-01-14,5,9523,506,4383,1838,0,21,16271
2023-01-14,6,9512,987,4614,1470,0,22,16605
2023-01-14,7,9510,1613,4867,1291,0,22,17303
2023-01-14,8,9513,1793,4945,1354,0,27,17632
2023-01-14,9,9508,2211,5508,923,5,32,18187
2023-01-14,10,9513,3097,5683,570,28,32,18923
2023-01-14,11,9511,2745,5571,654,61,33,18575
2023-01-14,12,9509,2537,5582,714,112,33,18487
2023-01-14,13,9513,2082,5579,592,157,32,17955
2023-01-14,14,9520,1992,5020,817,168,34,17551
2023-01-14,15,9519,2267,4815,897,153,34,17685
2023-01-14,16,9518,2474,5191,702,94,33,18012
2023-01-14,17,9518,2496,5935,521,25,33,18528
2023-01-14,18,9515,3309,6283,407,0,32,19546
2023-01-14,19,9515,3283,6410,460,0,33,19701
2023-01-14,20,9517,2728,6453,480,0,33,19211
2023-01-14,21,9517,2704,6158,484,0,33,18896
2023-01-14,22,9514,2438,5813,609,0,33,18407
2023-01-14,23,9506,2099,5398,522,0,33,17558
2023-01-14,24,9504,1431,5238,422,0,26,16621
2023-01-15,1,9504,1369,4345,415,0,22,15655
2023-01-15,2,9509,1351,4424,361,0,22,15667
2023-01-15,3,9509,1352,4321,293,0,22,15497
2023-01-15,4,9505,1495,4487,271,0,22,15780
2023-01-15,5,9500,1815,4127,303,0,22,15767
2023-01-15,6,9499,2119,4443,337,0,22,16420
2023-01-15,7,9507,2118,4126,353,0,22,16126
2023-01-15,8,9507,1869,4566,419,0,27,16388
2023-01-15,9,9506,2254,5008,466,15,32,17281
2023-01-15,10,9502,2303,4964,480,49,33,17331
2023-01-15,11,9506,1986,5048,409,103,33,17085
2023-01-15,12,9503,1915,5163,437,125,33,17176
2023-01-15,13,9499,2072,4751,457,136,34,16949
2023-01-15,14,9502,2364,4571,472,165,33,17107
2023-01-15,15,9510,2553,4705,467,177,33,17445
2023-01-15,16,9509,2650,4753,481,138,33,17564
2023-01-15,17,9489,2766,5583,526,36,33,18433
2023-01-15,18,9485,3013,6033,644,0,33,19208
2023-01-15,19,9484,3067,5753,956,0,34,19294
2023-01-15,20,9490,2756,5429,1325,0,34,19034
2023-01-15,21,9483,2457,5024,1474,0,34,18472
2023-01-15,22,9492,1897,4635,1635,0,34,17693
2023-01-15,23,9496,1304,4212,1761,0,34,16807
2023-01-15,24,9495,810,3726,1950,0,29,16010
2023-01-16,1,9501,807,3591,1802,0,24,15725
2023-01-16,2,9496,717,3785,1736,0,24,15758
2023-01-16,3,9492,736,3750,1836,0,24,15838
2023-01-16,4,9487,827,3761,1845,0,24,15944
2023-01-16,5,9496,1245,3612,1848,0,24,16225
2023-01-16,6,9503,1757,3426,1959,0,24,16669
2023-01-16,7,9504,2134,4289,1856,0,29,17812
2023-01-16,8,9503,2273,4989,2089,0,33,18887
2023-01-16,9,9497,2865,5408,1817,38,33,19658
2023-01-16,10,9497,2103,5343,1882,149,33,19007
2023-01-16,11,9491,1985,4861,1919,245,32,18533
2023-01-16,12,9486,2047,4600,1742,302,32,18209
2023-01-16,13,9488,2123,4221,1743,315,31,17921
2023-01-16,14,9489,2193,4234,1695,309,31,17951
2023-01-16,15,9494,2131,4419,1681,244,31,18000
2023-01-16,16,9491,2137,4921,1810,128,31,18518
2023-01-16,17,9495,2191,5539,2357,17,32,19631
2023-01-16,18,9493,2104,5437,2742,0,32,19808
2023-01-16,19,9489,2098,5177,2690,0,33,19487
2023-01-16,20,9488,1800,4964,2783,0,33,19068
2023-01-16,21,9481,1589,4894,2969,0,34,18967
2023-01-16,22,9478,1053,4493,2960,0,33,18017
2023-01-16,23,9478,612,3957,2952,0,33,17032
2023-01-16,24,9475,214,3734,2743,0,25,16191
2023-01-17,1,9473,133,3654,2693,0,23,15976
2023-01-17,2,9473,206,3616,2521,0,23,15839
2023-01-17,3,9476,216,3733,2345,0,23,15793
2023-01-17,4,9475,578,3748,2198,0,23,16022
2023-01-17,5,9481,1103,3638,2261,0,23,16506
2023-01-17,6,9483,1868,3872,2103,0,23,17349
2023-01-17,7,9483,2223,4645,2426,0,28,18805
2023-01-17,8,9481,2375,5100,2557,1,33,19547
2023-01-17,9,9477,2456,5401,2579,9,33,19955
2023-01-17,10,9468,2451,4666,1900,21,33,18539
2023-01-17,11,9469,2449,4696,2458,42,33,19147
2023-01-17,12,9467,2449,4873,2511,61,33,19394
2023-01-17,13,9460,2459,4889,2598,53,33,19492
2023-01-17,14,9465,2489,4983,2595,53,33,19618
2023-01-17,15,9468,2389,5379,2248,29,33,19546
2023-01-17,16,9470,2352,5337,2383,32,33,19607
2023-01-17,17,9467,2350,5104,2708,8,33,19670
2023-01-17,18,9464,2352,5906,2752,0,33,20507
2023-01-17,19,9463,2351,5404,2738,0,33,19989
2023-01-17,20,9468,2221,5529,2750,0,34,20002
2023-01-17,21,9467,1776,5258,2773,0,33,19307
2023-01-17,22,9439,1398,4358,2726,0,33,17954
2023-01-17,23,9458,880,3823,2778,0,33,16972
2023-01-17,24,9459,236,3606,2731,0,25,16057
2023-01-18,1,9454,127,3445,2287,0,22,15335
2023-01-18,2,9449,127,3305,2167,0,22,15070
2023-01-18,3,9453,128,3384,2079,0,22,15066
2023-01-18,4,9443,201,3378,2222,0,22,15266
2023-01-18,5,9438,432,3439,2694,0,10,16013
2023-01-18,6,9444,778,3669,2535,0,18,16444
2023-01-18,7,9442,1045,4371,2259,0,30,17147
2023-01-18,8,9440,1503,5240,2068,0,32,18283
2023-01-18,9,9443,2074,5436,1933,2,33,18921
2023-01-18,10,9442,2611,5274,1465,23,32,18847
2023-01-18,11,9442,2964,5456,1240,58,33,19193
2023-01-18,12,9437,3060,5117,1068,46,33,18761
2023-01-18,13,9435,3105,5086,1023,48,33,18730
2023-01-18,14,9438,3107,5289,816,46,36,18732
2023-01-18,15,9441,3146,4960,776,59,33,18415
2023-01-18,16,9445,3235,5132,542,32,33,18419
2023-01-18,17,9443,3103,5868,345,4,33,18796
2023-01-18,18,9453,4038,6082,218,0,33,19824
2023-01-18,19,9451,3284,5920,384,0,32,19071
2023-01-18,20,9451,2962,5792,410,0,32,18647
2023-01-18,21,9448,2796,5357,433,0,32,18066
2023-01-18,22,9444,2497,5086,458,0,32,17517
2023-01-18,23,9445,1495,5238,495,0,32,16705
2023-01-18,24,9444,906,4981,685,0,27,16043
2023-01-19,1,9445,841,4628,1048,0,22,15984
2023-01-19,2,9443,554,3676,1587,0,22,15282
2023-01-19,3,9444,181,3757,2174,0,22,15578
2023-01-19,4,9442,123,4009,2447,0,22,16043
2023-01-19,5,9449,225,3890,2823,0,22,16409
2023-01-19,6,9449,411,3551,3021,0,22,16454
2023-01-19,7,9453,824,3823,2980,0,27,17107
2023-01-19,8,9451,850,4064,3863,0,32,18260
2023-01-19,9,9442,1057,4499,4000,2,33,19033
2023-01-19,10,9438,1316,4656,3886,12,33,19341
2023-01-19,11,9429,1550,4863,3778,27,33,19680
2023-01-19,12,9429,1814,4945,3439,34,33,19694
2023-01-19,13,9424,2077,5130,3051,34,33,19749
2023-01-19,14,9422,2069,4788,3280,32,33,19624
2023-01-19,15,9414,2142,4505,2739,26,32,18858
2023-01-19,16,9421,2133,5328,1934,18,32,18866
2023-01-19,17,9432,2649,5568,1481,3,31,19164
2023-01-19,18,9432,2866,5711,1324,0,30,19363
2023-01-19,19,9438,3012,5693,1143,0,30,19316
2023-01-19,20,9440,3004,5677,913,0,30,19064
2023-01-19,21,9440,2360,5707,975,0,30,18512
2023-01-19,22,9441,2014,4931,1469,0,30,17885
2023-01-19,23,9444,1194,4285,1807,0,30,16760
2023-01-19,24,9445,614,4239,2067,0,25,16390
2023-01-20,1,9449,241,4186,2337,0,20,16233
2023-01-20,2,9450,132,3946,2418,0,20,15966
2023-01-20,3,9452,132,4072,2498,0,20,16174
2023-01-20,4,9451,213,4414,2513,0,20,16611
2023-01-20,5,9443,465,4288,2467,0,20,16683
2023-01-20,6,9441,858,4057,2188,0,20,16564
2023-01-20,7,9445,1503,4299,2052,0,20,17319
2023-01-20,8,9450,1688,4609,2027,0,26,17800
2023-01-20,9,9445,2499,4824,1917,3,32,18720
2023-01-20,10,9451,2874,4709,1708,22,32,18796
2023-01-20,11,9447,2944,4682,1605,54,32,18764
2023-01-20,12,9442,2360,4723,1944,75,32,18576
2023-01-20,13,9454,2465,4253,2116,88,33,18409
2023-01-20,14,9456,2458,4462,1649,82,32,18139
2023-01-20,15,9459,2461,4865,1277,82,33,18177
2023-01-20,16,9464,2332,4985,1328,42,33,18184
2023-01-20,17,9458,2414,5437,1364,9,33,18715
2023-01-20,18,9459,2505,6004,1276,0,33,19277
2023-01-20,19,9459,2542,5910,1218,0,32,19161
2023-01-20,20,9457,2493,5809,1150,0,32,18941
2023-01-20,21,9458,2378,5716,990,0,32,18574
2023-01-20,22,9449,1872,5492,749,0,32,17594
2023-01-20,23,9459,1856,5208,563,0,32,17118
2023-01-20,24,9458,1691,4782,323,0,22,16276
2023-01-21,1,9454,1294,4722,169,0,19,15658
2023-01-21,2,9456,1271,4510,107,0,19,15363
2023-01-21,3,9449,1164,4219,125,0,19,14976
2023-01-21,4,9440,1313,4096,227,0,19,15095
2023-01-21,5,9444,1283,4059,311,0,19,15116
2023-01-21,6,9452,1286,4093,281,0,19,15131
2023-01-21,7,9459,1291,4637,238,0,22,15647
2023-01-21,8,9459,1484,5154,218,0,26,16341
2023-01-21,9,9461,1717,5496,181,0,33,16888
2023-01-21,10,9462,2212,5680,170,14,32,17570
2023-01-21,11,9462,2676,5478,111,28,33,17788
2023-01-21,12,9460,3185,5180,189,36,33,18083
2023-01-21,13,9462,2940,5042,381,33,33,17891
2023-01-21,14,9460,2584,4996,714,28,33,17815
2023-01-21,15,9472,2328,5110,683,25,33,17651
2023-01-21,16,9483,2313,5329,557,16,33,17731
2023-01-21,17,9483,2348,5758,527,2,33,18151
2023-01-21,18,9480,2436,6003,658,0,33,18610
2023-01-21,19,9477,2418,5834,763,0,33,18525
2023-01-21,20,9480,2127,5783,743,0,33,18166
2023-01-21,21,9481,1584,5725,776,0,33,17599
2023-01-21,22,9483,1394,5271,900,0,33,17081
2023-01-21,23,9478,1167,4885,790,0,33,16353
2023-01-21,24,9482,643,4682,714,0,23,15544
2023-01-22,1,9484,506,4564,684,0,20,15258
2023-01-22,2,9489,504,4502,604,0,20,15119
2023-01-22,3,9504,363,4301,530,0,20,14718
2023-01-22,4,9563,316,4316,292,0,26,14513
2023-01-22,5,9585,463,4652,190,0,33,14923
2023-01-22,6,9584,566,4572,195,0,33,14950
2023-01-22,7,9591,859,4559,153,0,34,15196
2023-01-22,8,9591,1200,4832,118,0,32,15773
2023-01-22,9,9596,1523,5421,124,0,34,16698
2023-01-22,10,9642,1600,5638,192,4,34,17110
2023-01-22,11,9700,1832,5574,239,12,34,17391
2023-01-22,12,9761,2240,5608,180,14,35,17838
2023-01-22,13,9832,2358,5469,95,18,34,17806
2023-01-22,14,9860,2352,5535,69,20,34,17870
2023-01-22,15,9861,2364,5431,59,12,35,17762
2023-01-22,16,9868,2426,5564,43,4,34,17939
2023-01-22,17,9864,2532,6069,27,1,34,18527
2023-01-22,18,9865,2968,6333,28,0,34,19228
2023-01-22,19,9867,3121,6226,44,0,34,19292
2023-01-22,20,9867,2621,6048,126,0,34,18696
2023-01-22,21,9866,2290,5952,151,0,35,18294
2023-01-22,22,9863,1585,5501,197,0,35,17181
2023-01-22,23,9890,1224,5059,233,0,34,16440
2023-01-22,24,9929,1074,4637,260,0,30,15930
2023-01-23,1,9977,664,4559,309,0,22,15531
2023-01-23,2,9972,407,4403,416,0,22,15220
2023-01-23,3,9973,619,4130,542,0,22,15286
2023-01-23,4,9973,802,4252,642,0,28,15697
2023-01-23,5,9971,1060,3904,720,0,39,15694
2023-01-23,6,9964,1578,3873,619,0,42,16076
2023-01-23,7,9970,1969,4506,675,0,50,17170
2023-01-23,8,9971,2281,5554,623,0,52,18481
2023-01-23,9,9971,2485,5853,537,0,49,18895
2023-01-23,10,9969,2486,5965,523,2,35,18980
2023-01-23,11,10021,2276,5853,603,13,33,18799
2023-01-23,12,10025,2300,5518,694,25,33,18595
2023-01-23,13,10028,2465,5276,770,24,33,18596
2023-01-23,14,10027,2167,4796,1162,20,33,18205
2023-01-23,15,10024,1991,4989,1307,17,33,18361
2023-01-23,16,10027,2274,4647,1448,11,33,18440
2023-01-23,17,10024,2413,4602,1558,1,33,18631
2023-01-23,18,10034,2335,4709,2703,0,33,19814
2023-01-23,19,10064,2066,4495,2971,0,33,19629
2023-01-23,20,10063,1620,4355,3149,0,34,19221
2023-01-23,21,10064,1162,4174,3352,0,34,18786
2023-01-23,22,10056,780,3848,3755,0,34,18473
2023-01-23,23,10052,354,3844,3924,0,34,18208
2023-01-23,24,10043,132,3694,3933,0,25,17827
2023-01-24,1,10048,131,3581,3895,0,24,17679
2023-01-24,2,10056,132,3618,3919,0,23,17748
2023-01-24,3,10059,132,3753,4086,0,23,18053
2023-01-24,4,10060,132,3766,4089,0,23,18070
2023-01-24,5,10065,333,3544,3879,0,23,17844
2023-01-24,6,9978,761,3471,3096,0,23,17329
2023-01-24,7,9977,917,3822,3020,0,28,17764
2023-01-24,8,9973,920,4343,3515,0,33,18784
2023-01-24,9,9967,1026,4353,3272,2,46,18666
2023-01-24,10,9972,1249,4491,2912,10,41,18675
2023-01-24,11,9932,1652,4685,2618,34,49,18970
2023-01-24,12,10010,1783,4207,2152,70,51,18273
2023-01-24,13,10010,1912,4182,1684,89,40,17917
2023-01-24,14,10011,1980,4325,1246,170,33,17765
2023-01-24,15,10001,2086,4888,950,173,31,18129
2023-01-24,16,10009,2325,5004,930,95,26,18389
2023-01-24,17,10010,2448,5586,780,37,10,18871
2023-01-24,18,10007,3067,5810,638,1,4,19527
2023-01-24,19,10006,3252,5578,790,0,7,19633
2023-01-24,20,10013,3041,5619,752,0,7,19432
2023-01-24,21,10008,2866,5401,808,0,4,19087
2023-01-24,22,10010,2360,5402,557,0,10,18339
2023-01-24,23,10004,1959,5316,464,0,19,17762
2023-01-24,24,10001,1341,4669,389,0,23,16423
2023-01-25,1,9998,1298,4324,370,0,22,16012
2023-01-25,2,9997,1244,4144,446,0,22,15853
2023-01-25,3,10006,1201,3875,489,0,22,15593
2023-01-25,4,10006,1334,3747,579,0,22,15688
2023-01-25,5,10008,1731,3684,305,0,22,15750
2023-01-25,6,10006,2147,3799,485,0,22,16459
2023-01-25,7,10015,2498,4006,917,0,25,17461
2023-01-25,8,10012,2637,4791,1630,0,31,19101
2023-01-25,9,10013,2754,5013,1760,4,31,19575
2023-01-25,10,10010,2599,4350,1951,13,31,18954
2023-01-25,11,10013,2239,4446,2397,16,31,19142
2023-01-25,12,10017,2202,4342,2600,17,30,19208
2023-01-25,13,10002,2390,4201,2699,22,30,19344
2023-01-25,14,10035,2379,4070,3010,13,30,19537
2023-01-25,15,10028,2365,4156,2775,9,31,19364
2023-01-25,16,10027,2142,4192,3112,3,30,19506
2023-01-25,17,10031,2243,4962,2988,0,31,20255
2023-01-25,18,10030,2951,5541,2345,0,31,20898
2023-01-25,19,10035,3114,5396,2138,0,31,20714
2023-01-25,20,10035,2401,5252,2315,0,32,20035
2023-01-25,21,10033,2108,4900,2293,0,32,19366
2023-01-25,22,10034,1378,4404,2487,0,30,18333
2023-01-25,23,10031,1021,3823,2775,0,30,17680
2023-01-25,24,10029,506,3634,2661,0,26,16856
2023-01-26,1,10030,187,3677,3006,0,22,16922
2023-01-26,2,10028,155,3800,3076,0,22,17081
2023-01-26,3,10028,155,4113,3026,0,23,17345
2023-01-26,4,10032,234,3977,3174,0,23,17440
2023-01-26,5,10029,524,3858,3084,0,23,17518
2023-01-26,6,10028,1323,3796,2162,0,23,17332
2023-01-26,7,10027,2050,4102,2476,0,28,18683
2023-01-26,8,10028,2324,4369,2406,0,32,19159
2023-01-26,9,10028,2364,4430,2338,0,32,19192
2023-01-26,10,10024,2479,4762,2015,7,32,19319
2023-01-26,11,10028,2637,4778,1717,20,27,19207
2023-01-26,12,10027,2783,4824,1274,30,21,18959
2023-01-26,13,10031,2247,4836,989,39,21,18163
2023-01-26,14,9866,2336,4873,861,41,21,17998
2023-01-26,15,9836,2567,4874,689,44,21,18031
2023-01-26,16,9839,2863,4730,556,37,21,18046
2023-01-26,17,10021,2948,5246,468,12,21,18716
2023-01-26,18,10052,3052,5828,449,0,24,19405
2023-01-26,19,10047,3396,5886,672,0,17,20018
2023-01-26,20,10050,2965,5392,1105,0,23,19535
2023-01-26,21,10054,2773,5177,1386,0,31,19421
2023-01-26,22,10044,2266,4956,1644,0,31,18941
2023-01-26,23,10049,1557,4643,1617,0,31,17897
2023-01-26,24,10056,1223,4443,1803,0,25,17550
2023-01-27,1,10053,843,4320,1795,0,20,17031
2023-01-27,2,10060,732,4117,2029,0,20,16958
2023-01-27,3,10060,736,4117,1797,0,20,16730
2023-01-27,4,10057,736,3932,2344,0,20,17089
2023-01-27,5,10053,912,3960,2367,0,20,17312
2023-01-27,6,10061,1294,4071,1744,0,20,17190
2023-01-27,7,10059,1770,4484,1762,0,28,18103
2023-01-27,8,10065,1811,5344,2000,0,32,19252
2023-01-27,9,10071,2299,5459,1943,5,32,19809
2023-01-27,10,10065,1883,5152,2383,20,32,19535
2023-01-27,11,10056,1454,4569,3042,33,32,19186
2023-01-27,12,10039,1184,4272,3105,30,32,18662
2023-01-27,13,10059,865,4161,3639,26,32,18782
2023-01-27,14,10075,742,4123,3909,35,32,18916
2023-01-27,15,10074,743,4367,4246,31,32,19493
2023-01-27,16,10095,745,4617,4422,14,33,19926
2023-01-27,17,10087,744,4580,4479,8,32,19930
2023-01-27,18,10096,745,4600,4361,1,32,19835
2023-01-27,19,10046,743,4951,4361,0,32,20133
2023-01-27,20,10044,745,4840,4427,0,32,20088
2023-01-27,21,10040,322,4521,4503,0,32,19418
2023-01-27,22,10044,128,4239,4535,0,32,18978
2023-01-27,23,10042,127,3942,4565,0,31,18707
2023-01-27,24,10035,127,3520,4500,0,25,18207
2023-01-28,1,10032,127,3318,4324,0,21,17822
2023-01-28,2,10031,127,3371,4009,0,20,17558
2023-01-28,3,10039,126,3344,3903,0,20,17432
2023-01-28,4,10039,126,3341,3933,0,20,17459
2023-01-28,5,10036,127,3218,3942,0,20,17343
2023-01-28,6,10034,250,3286,3728,0,20,17318
2023-01-28,7,10039,529,3639,3416,0,28,17651
2023-01-28,8,10041,748,3957,3098,0,30,17874
2023-01-28,9,10040,769,4349,2540,10,31,17739
2023-01-28,10,10038,873,4712,2233,35,31,17922
2023-01-28,11,10026,1026,4669,1893,85,31,17730
2023-01-28,12,10017,1188,5037,1563,139,31,17975
2023-01-28,13,10027,1640,4501,1317,150,31,17666
2023-01-28,14,10041,1661,4179,1314,129,31,17355
2023-01-28,15,10042,1691,4516,1270,116,31,17666
2023-01-28,16,10040,1931,4736,939,81,31,17758
2023-01-28,17,10033,2355,4995,813,27,23,18246
2023-01-28,18,10037,2380,5763,467,0,23,18670
2023-01-28,19,10042,2576,5979,141,0,23,18761
2023-01-28,20,10040,2301,5821,115,0,23,18300
2023-01-28,21,10040,2162,5286,216,0,23,17727
2023-01-28,22,10037,1510,5138,369,0,23,17077
2023-01-28,23,10037,632,4758,600,0,23,16050
2023-01-28,24,10036,163,4510,823,0,19,15551
2023-01-29,1,10030,138,4648,769,0,20,15605
2023-01-29,2,10032,138,4418,756,0,19,15363
2023-01-29,3,10030,138,4309,883,0,0,15360
2023-01-29,4,10036,140,4507,838,0,0,15521
2023-01-29,5,10041,138,4294,1071,0,0,15544
2023-01-29,6,10042,135,3785,1671,0,2,15635
2023-01-29,7,10043,131,4021,1624,0,17,15836
2023-01-29,8,10042,254,4632,1707,0,16,16651
2023-01-29,9,10043,433,4669,1782,4,10,16941
2023-01-29,10,10040,982,4598,1665,20,27,17332
2023-01-29,11,10031,1430,4589,1450,33,26,17559
2023-01-29,12,10032,1902,4726,1667,41,23,18391
2023-01-29,13,10033,2164,4464,1633,60,23,18377
2023-01-29,14,10036,2363,4409,1745,55,23,18631
2023-01-29,15,10036,2490,4459,2112,54,23,19174
2023-01-29,16,10038,2588,4442,1499,42,23,18632
2023-01-29,17,10039,2590,4566,1591,17,23,18826
2023-01-29,18,10036,2858,5488,1350,0,24,19756
2023-01-29,19,10036,3487,5622,1030,0,24,20199
2023-01-29,20,10040,2983,5537,699,0,24,19283
2023-01-29,21,10036,2708,5441,453,0,25,18663
2023-01-29,22,10032,2372,5162,467,0,25,18058
2023-01-29,23,10029,1845,4750,548,0,25,17197
2023-01-29,24,10028,1699,4420,554,0,19,16720
2023-01-30,1,10024,1712,4185,382,0,15,16318
2023-01-30,2,10028,1786,4071,394,0,15,16294
2023-01-30,3,10029,1789,3971,418,0,15,16222
2023-01-30,4,10029,1908,4212,395,0,15,16559
2023-01-30,5,10029,2295,3894,331,0,15,16564
2023-01-30,6,10027,2644,3954,271,0,29,16925
2023-01-30,7,10032,3037,4737,424,0,63,18293
2023-01-30,8,10036,4117,5069,383,0,74,19679
2023-01-30,9,10033,4301,5047,452,1,84,19918
2023-01-30,10,10034,4429,4931,384,11,85,19874
2023-01-30,11,10030,4492,4953,353,32,85,19945
2023-01-30,12,10032,4030,4856,536,85,87,19626
2023-01-30,13,10031,3752,4789,847,85,85,19589
2023-01-30,14,10028,3395,4628,939,87,84,19161
2023-01-30,15,10027,3638,4530,1151,73,83,19502
2023-01-30,16,10025,3411,4513,1312,50,84,19395
2023-01-30,17,10019,3452,4919,1601,16,82,20089
2023-01-30,18,10026,3900,5054,1734,0,81,20795
2023-01-30,19,10034,4090,5220,1614,0,86,21044
2023-01-30,20,10036,3535,5403,1846,0,80,20900
2023-01-30,21,10030,3200,5011,2271,0,80,20592
2023-01-30,22,10028,2859,4405,2524,0,80,19896
2023-01-30,23,10028,1900,4251,2350,0,38,18567
2023-01-30,24,10032,1601,4071,2535,0,19,18258
2023-01-31,1,10028,1734,4033,2470,0,17,18282
2023-01-31,2,10032,1947,3865,2490,0,17,18351
2023-01-31,3,10033,1982,4282,2075,0,17,18389
2023-01-31,4,10028,2094,4386,1916,0,17,18441
2023-01-31,5,10024,2197,3767,1793,0,18,17799
2023-01-31,6,10030,2457,4029,1505,0,25,18046
2023-01-31,7,10037,2925,5233,1303,0,65,19563
2023-01-31,8,10027,3845,5847,994,0,91,20804
2023-01-31,9,10029,4297,5849,715,27,88,21005
2023-01-31,10,10026,4255,5612,389,111,83,20476
2023-01-31,11,10032,3528,5514,279,193,83,19629
2023-01-31,12,10039,3253,5185,252,198,84,19011
2023-01-31,13,10043,3298,5091,225,175,84,18916
2023-01-31,14,10042,3118,5161,213,143,85,18762
2023-01-31,15,10045,3212,5168,244,144,85,18898
2023-01-31,16,10041,3180,5259,301,76,81,18938
2023-01-31,17,10047,3354,6220,379,22,77,20099
2023-01-31,18,10049,4604,6227,342,2,83,21307
2023-01-31,19,10040,5051,6069,354,0,82,21596
2023-01-31,20,10036,4912,5949,474,0,81,21452
2023-01-31,21,10038,4660,5916,786,0,80,21480
2023-01-31,22,10031,3832,5635,1152,0,36,20686
2023-01-31,23,10035,3210,4507,1510,0,30,19292
2023-01-31,24,10024,2733,4121,1280,0,25,18183
2023-02-01,1,10023,1696,4346,1849,0,20,17934
2023-02-01,2,10020,1472,4295,2078,0,20,17885
2023-02-01,3,10011,1831,3998,1951,0,20,17811
2023-02-01,4,10025,2266,3874,1924,0,20,18109
2023-02-01,5,10031,2514,3891,1773,0,20,18229
2023-02-01,6,10030,2836,4095,2176,0,39,19176
2023-02-01,7,10029,3057,5151,2240,0,68,20545
2023-02-01,8,10028,3837,5857,2275,1,79,22077
2023-02-01,9,10022,3773,5843,2620,46,80,22384
2023-02-01,10,10024,3796,5648,2532,120,82,22202
2023-02-01,11,10023,3372,5136,2345,174,83,21133
2023-02-01,12,10027,2521,4915,2542,202,83,20290
2023-02-01,13,10020,2301,4733,2619,212,82,19967
2023-02-01,14,10018,2641,4574,2472,202,84,19991
2023-02-01,15,10012,3052,4265,2757,193,45,20324
2023-02-01,16,9989,2861,4365,2299,152,32,19698
2023-02-01,17,9989,2536,5037,2437,61,32,20092
2023-02-01,18,9990,2553,5268,3194,3,32,21040
2023-02-01,19,9987,2620,5060,3217,0,32,20916
2023-02-01,20,9987,2441,4994,3350,0,31,20803
2023-02-01,21,9980,2272,4609,3055,0,31,19947
2023-02-01,22,9980,1531,4546,3063,0,31,19151
2023-02-01,23,9990,759,4145,2535,0,31,17460
2023-02-01,24,9994,308,3907,2365,0,22,16596
2023-02-02,1,9994,239,3886,2281,0,20,16420
2023-02-02,2,9994,239,3977,1568,0,20,15798
2023-02-02,3,9988,239,3913,1249,0,20,15409
2023-02-02,4,9991,335,3867,1181,0,20,15394
2023-02-02,5,9992,527,3707,1297,0,20,15543
2023-02-02,6,9933,666,3781,1561,0,20,15961
2023-02-02,7,9936,677,4032,2381,0,26,17052
2023-02-02,8,9939,717,4424,3003,0,29,18112
2023-02-02,9,9935,760,4336,3502,18,29,18580
2023-02-02,10,9931,1027,4253,3301,109,29,18650
2023-02-02,11,9937,1033,3952,3346,134,29,18431
2023-02-02,12,9958,822,3859,3150,161,33,17983
2023-02-02,13,9985,837,3771,3022,202,41,17858
2023-02-02,14,9980,1004,3622,2766,199,42,17613
2023-02-02,15,9989,1083,3740,2830,186,43,17871
2023-02-02,16,9988,1196,4358,3631,109,42,19324
2023-02-02,17,9980,957,4550,3966,32,37,19522
2023-02-02,18,9983,896,4713,4349,1,31,19973
2023-02-02,19,9983,895,4687,4276,0,30,19871
2023-02-02,20,9976,795,4747,4397,0,30,19945
2023-02-02,21,9976,738,4523,4387,0,30,19654
2023-02-02,22,9974,602,4180,4141,0,30,18927
2023-02-02,23,9976,267,3951,3613,0,30,17837
2023-02-02,24,9974,199,3956,2947,0,21,17097
2023-02-03,1,9983,199,3873,3163,0,20,17238
2023-02-03,2,9979,242,3840,2631,0,20,16712
2023-02-03,3,9976,280,3859,2611,0,20,16746
2023-02-03,4,9974,700,3747,2641,0,0,17062
2023-02-03,5,9983,1449,3846,2792,0,0,18070
2023-02-03,6,9974,2239,3977,3147,0,0,19337
2023-02-03,7,9974,2832,4858,3455,0,0,21119
2023-02-03,8,9983,3673,5522,3295,2,0,22475
2023-02-03,9,9984,4104,5486,3138,59,0,22771
2023-02-03,10,9983,3993,5518,3197,157,0,22848
2023-02-03,11,9988,3526,5301,3205,206,0,22226
2023-02-03,12,9990,3339,5140,3124,215,0,21808
2023-02-03,13,9994,3530,4935,3162,233,0,21854
2023-02-03,14,9990,3758,5082,3119,214,0,22163
2023-02-03,15,9996,4138,5304,3068,207,30,22743
2023-02-03,16,9991,4725,5287,2892,159,50,23104
2023-02-03,17,9988,5237,5560,2637,71,91,23584
2023-02-03,18,9983,6132,6022,2263,6,135,24541
2023-02-03,19,10000,6239,5875,2119,0,114,24347
2023-02-03,20,10004,6076,5964,2120,0,81,24245
2023-02-03,21,10004,5996,5893,1820,0,84,23797
2023-02-03,22,9994,5734,5979,1514,0,84,23305
2023-02-03,23,9996,5226,5839,1065,0,84,22210
2023-02-03,24,9996,4975,5706,762,0,77,21516
2023-02-04,1,9987,5103,5223,709,0,74,21096
2023-02-04,2,9994,5103,5188,769,0,76,21130
2023-02-04,3,9992,5072,5124,787,0,78,21053
2023-02-04,4,9995,4302,5125,1010,0,82,20514
2023-02-04,5,9999,4597,5021,1284,0,83,20984
2023-02-04,6,9996,4315,4949,1814,0,86,21160
2023-02-04,7,9998,3728,5362,2382,0,82,21552
2023-02-04,8,9999,3674,5440,2750,0,84,21947
2023-02-04,9,9915,4045,5142,3064,7,85,22258
2023-02-04,10,8790,4872,5582,2838,16,89,22187
2023-02-04,11,9094,4874,5117,3067,52,93,22297
2023-02-04,12,9098,4665,5033,3262,96,85,22239
2023-02-04,13,9114,5024,4814,3271,103,85,22411
2023-02-04,14,9122,5077,4773,3298,126,86,22482
2023-02-04,15,9123,4657,4753,3277,179,85,22074
2023-02-04,16,9121,4730,4849,3228,136,85,22149
2023-02-04,17,9122,4535,4925,3111,52,86,21831
2023-02-04,18,9124,4911,5284,3069,4,88,22480
2023-02-04,19,9125,5225,5502,3060,0,86,22998
2023-02-04,20,9123,4732,5065,3014,0,85,22019
2023-02-04,21,9116,3848,4929,3060,0,83,21036
2023-02-04,22,9410,3255,4825,3039,0,91,20620
2023-02-04,23,9727,2674,4695,3081,0,86,20263
2023-02-04,24,9954,1695,4016,3089,0,41,18795
2023-02-05,1,10030,1214,3516,2720,0,21,17501
2023-02-05,2,10032,929,3412,2818,0,21,17212
2023-02-05,3,10040,928,3407,2806,0,21,17202
2023-02-05,4,10033,929,3389,2817,0,21,17189
2023-02-05,5,10016,927,3434,2686,0,21,17084
2023-02-05,6,10017,985,3626,2845,0,21,17494
2023-02-05,7,10032,1179,3941,2968,0,26,18146
2023-02-05,8,10036,1420,3883,2568,0,28,17935
2023-02-05,9,10030,1618,4059,2521,16,31,18275
2023-02-05,10,10036,2017,4138,2453,50,37,18731
2023-02-05,11,10035,2199,4117,2630,110,69,19160
2023-02-05,12,10034,2162,3969,2109,105,84,18463
2023-02-05,13,10032,2280,3984,2319,128,84,18827
2023-02-05,14,10031,2122,3950,1813,75,84,18075
2023-02-05,15,10029,2369,3930,1946,58,86,18418
2023-02-05,16,10030,2755,3947,1615,39,85,18471
2023-02-05,17,10028,3285,4435,1769,12,86,19615
2023-02-05,18,10024,3408,4572,2069,0,84,20157
2023-02-05,19,10022,3568,4706,2031,0,85,20412
2023-02-05,20,10019,3268,4744,1720,0,85,19836
2023-02-05,21,10021,2734,4667,1859,0,43,19324
2023-02-05,22,10020,1511,4423,1881,0,31,17866
2023-02-05,23,10026,711,4211,2114,0,31,17093
2023-02-05,24,10023,509,3909,2083,0,23,16547
2023-02-06,1,10013,509,3617,2061,0,21,16221
2023-02-06,2,10018,509,3674,2104,0,21,16326
2023-02-06,3,10010,509,3836,2053,0,21,16429
2023-02-06,4,10006,551,4342,1584,0,21,16504
2023-02-06,5,10007,814,4146,1499,0,21,16487
2023-02-06,6,10011,1407,4273,1507,0,21,17219
2023-02-06,7,10025,2291,4880,1477,0,29,18702
2023-02-06,8,10024,2690,5353,1373,1,33,19474
2023-02-06,9,10021,3329,5282,1198,30,33,19893
2023-02-06,10,10017,3155,5238,933,116,33,19492
2023-02-06,11,10014,2626,4979,623,204,33,18479
2023-02-06,12,10023,2409,4771,360,294,33,17890
2023-02-06,13,10019,2070,4663,277,329,33,17391
2023-02-06,14,10020,2078,4284,261,296,33,16972
2023-02-06,15,9978,2447,4223,163,158,33,17002
2023-02-06,16,10015,2747,4276,193,157,38,17426
2023-02-06,17,10020,2810,4862,282,71,69,18114
2023-02-06,18,10019,3158,5432,308,1,87,19005
2023-02-06,19,10031,3344,5815,559,0,84,19833
2023-02-06,20,10030,3328,5762,883,0,83,20086
2023-02-06,21,10029,3015,5338,1386,0,84,19852
2023-02-06,22,10016,1941,4367,2115,0,43,18482
2023-02-06,23,10026,583,4061,2567,0,31,17268
2023-02-06,24,10028,206,3593,2941,0,24,16792
2023-02-07,1,10028,129,3444,3133,0,20,16754
2023-02-07,2,10031,126,3450,3310,0,20,16937
2023-02-07,3,10030,126,3816,3385,0,20,17377
2023-02-07,4,10027,126,4148,3448,0,20,17769
2023-02-07,5,10028,126,4000,3482,0,24,17660
2023-02-07,6,9952,214,3642,3683,0,33,17524
2023-02-07,7,9942,356,4202,3813,0,40,18353
2023-02-07,8,9948,539,4303,4022,5,44,18861
2023-02-07,9,9946,545,4322,4124,54,42,19033
2023-02-07,10,9947,546,4271,4143,104,36,19047
2023-02-07,11,10018,605,4148,4192,88,41,19092
2023-02-07,12,10029,705,4476,4400,98,39,19747
2023-02-07,13,10028,686,4229,4235,81,39,19298
2023-02-07,14,10024,578,3569,4204,86,41,18502
2023-02-07,15,10026,599,3685,4158,66,39,18573
2023-02-07,16,10033,1047,3960,4243,72,44,19399
2023-02-07,17,10031,1101,4461,4239,26,46,19904
2023-02-07,18,10033,1008,4821,3954,2,44,19862
2023-02-07,19,10035,982,4942,3628,0,39,19626
2023-02-07,20,10035,978,5108,3302,0,34,19457
2023-02-07,21,10037,978,4808,3161,0,32,19016
2023-02-07,22,10037,456,4883,2693,0,32,18101
2023-02-07,23,10033,271,4894,2234,0,32,17464
2023-02-07,24,10025,174,4330,2151,0,26,16706
2023-02-08,1,10031,131,4122,2118,0,22,16424
2023-02-08,2,10023,130,4013,2220,0,22,16408
2023-02-08,3,10024,129,4178,2033,0,22,16386
2023-02-08,4,10027,125,4218,1927,0,22,16319
2023-02-08,5,10029,182,4340,1618,0,22,16191
2023-02-08,6,10025,252,4349,1506,0,22,16154
2023-02-08,7,10022,508,4864,1254,0,25,16673
2023-02-08,8,10027,652,5420,1353,1,32,17485
2023-02-08,9,10027,568,4959,1380,65,32,17031
2023-02-08,10,10026,515,4788,1118,175,33,16655
2023-02-08,11,10030,509,4380,834,235,33,16021
2023-02-08,12,10033,509,4279,631,289,33,15774
2023-02-08,13,10030,611,4156,692,310,33,15832
2023-02-08,14,10028,853,4116,536,343,32,15908
2023-02-08,15,10026,1104,4153,587,300,30,16200
2023-02-08,16,10027,1327,4448,516,150,32,16500
2023-02-08,17,10032,1467,4801,790,79,32,17201
2023-02-08,18,10027,1465,5427,1328,6,31,18284
2023-02-08,19,10031,1464,5342,1374,0,32,18243
2023-02-08,20,10031,1463,5212,1371,0,32,18109
2023-02-08,21,10031,1369,4707,1520,0,30,17657
2023-02-08,22,10026,878,4830,1713,0,30,17477
2023-02-08,23,10025,414,4743,1259,0,32,16473
2023-02-08,24,10026,394,4595,1212,0,25,16252
2023-02-09,1,10024,189,4308,1297,0,20,15838
2023-02-09,2,10026,176,4186,1241,0,20,15649
2023-02-09,3,10021,202,4573,1172,0,20,15988
2023-02-09,4,10025,301,4431,1350,0,20,16127
2023-02-09,5,10028,407,3940,1281,0,20,15676
2023-02-09,6,9952,521,4035,1131,0,22,15661
2023-02-09,7,9940,512,4264,1628,0,24,16368
2023-02-09,8,9939,513,4857,2291,1,30,17631
2023-02-09,9,9945,520,5010,2417,8,30,17930
2023-02-09,10,9945,517,5507,2670,19,30,18688
2023-02-09,11,10000,598,5698,2765,22,32,19115
2023-02-09,12,10040,532,5073,2986,38,31,18700
2023-02-09,13,10025,325,4680,2865,36,31,17962
2023-02-09,14,10027,171,4694,2877,38,31,17838
2023-02-09,15,10028,257,4621,2563,95,32,17596
2023-02-09,16,10029,296,4698,2544,84,32,17683
2023-02-09,17,10031,350,5097,3093,14,33,18618
2023-02-09,18,10029,445,5621,3076,1,33,19205
2023-02-09,19,10022,429,5020,3159,0,33,18663
2023-02-09,20,10034,351,4557,2999,0,30,17971
2023-02-09,21,10034,352,4633,3161,0,21,18201
2023-02-09,22,10030,452,4430,3261,0,22,18195
2023-02-09,23,10031,363,4123,3300,0,22,17839
2023-02-09,24,10036,268,4050,3005,0,22,17381
2023-02-10,1,10039,266,3904,3212,0,22,17443
2023-02-10,2,10038,132,3853,3419,0,22,17464
2023-02-10,3,10030,126,3972,3037,0,22,17187
2023-02-10,4,10034,126,3852,3212,0,22,17246
2023-02-10,5,10030,126,3816,3305,0,22,17299
2023-02-10,6,10024,125,4045,3336,0,22,17552
2023-02-10,7,10024,129,4696,3495,0,39,18383
2023-02-10,8,10028,134,4993,3396,0,67,18618
2023-02-10,9,10022,135,5245,3100,11,84,18597
2023-02-10,10,10017,242,5389,2942,25,83,18698
2023-02-10,11,10022,218,4964,3134,31,83,18452
2023-02-10,12,10024,198,4704,3231,54,83,18294
2023-02-10,13,10031,283,4497,3478,78,83,18450
2023-02-10,14,10027,346,4302,3405,104,83,18267
2023-02-10,15,10026,351,4305,3317,113,83,18195
2023-02-10,16,10019,353,4996,3395,92,83,18938
2023-02-10,17,10009,355,5740,3376,40,84,19604
2023-02-10,18,10007,382,5946,3225,5,84,19649
2023-02-10,19,10021,403,5608,3134,0,85,19251
2023-02-10,20,10023,362,5382,3082,0,46,18895
2023-02-10,21,10017,223,5082,3278,0,31,18631
2023-02-10,22,10013,128,4279,3292,0,31,17743
2023-02-10,23,10019,128,4111,3270,0,31,17559
2023-02-10,24,10016,128,4088,3146,0,22,17400
2023-02-11,1,10017,128,4188,2884,0,21,17238
2023-02-11,2,10011,129,4443,2463,0,21,17067
2023-02-11,3,10011,128,4547,2077,0,21,16784
2023-02-11,4,10028,245,4718,1454,0,21,16466
2023-02-11,5,10026,431,4889,915,0,21,16282
2023-02-11,6,10027,476,4548,767,0,21,15839
2023-02-11,7,10033,382,4671,701,0,26,15813
2023-02-11,8,10031,401,5129,701,8,29,16299
2023-02-11,9,10029,474,4906,801,81,30,16321
2023-02-11,10,9888,435,4506,1015,166,30,16040
2023-02-11,11,9213,631,4762,1384,222,30,16242
2023-02-11,12,9213,218,4638,1697,268,30,16064
2023-02-11,13,9195,140,4906,1828,338,30,16437
2023-02-11,14,9196,232,4509,2087,382,30,16436
2023-02-11,15,9194,290,4190,2410,366,29,16479
2023-02-11,16,9197,357,4191,2392,264,29,16430
2023-02-11,17,9192,359,4538,2728,110,29,16956
2023-02-11,18,9192,363,5496,3547,14,29,18641
2023-02-11,19,9205,367,5616,3785,0,30,19003
2023-02-11,20,9204,358,5382,3825,0,31,18800
2023-02-11,21,9204,357,4904,3924,0,32,18421
2023-02-11,22,9205,221,4256,3864,0,32,17578
2023-02-11,23,9209,129,4342,3790,0,32,17502
2023-02-11,24,9202,128,3994,3690,0,24,17038
2023-02-12,1,9204,128,3845,3410,0,23,16610
2023-02-12,2,9206,128,4232,2926,0,23,16515
2023-02-12,3,9204,166,4594,2419,0,22,16405
2023-02-12,4,9206,212,4654,1915,0,22,16009
2023-02-12,5,9206,298,4584,1503,0,22,15613
2023-02-12,6,9201,347,4565,1228,0,22,15363
2023-02-12,7,9206,443,4948,1104,0,26,15727
2023-02-12,8,9205,539,4906,1071,10,29,15760
2023-02-12,9,9205,544,4854,781,125,29,15538
2023-02-12,10,9204,643,4990,332,263,27,15459
2023-02-12,11,9208,664,4847,145,354,14,15232
2023-02-12,12,9207,819,4831,101,385,26,15369
2023-02-12,13,9210,971,4830,133,387,29,15560
2023-02-12,14,9205,1230,4367,242,383,29,15456
2023-02-12,15,9210,1557,4200,336,354,29,15686
2023-02-12,16,9208,1674,4165,315,262,29,15653
2023-02-12,17,9208,1685,4807,313,103,29,16145
2023-02-12,18,9215,1858,5830,413,16,29,17361
2023-02-12,19,9215,2202,5879,608,0,30,17934
2023-02-12,20,9213,1786,5484,779,0,29,17291
2023-02-12,21,9214,882,4700,1153,0,31,15980
2023-02-12,22,9216,581,4432,1593,0,31,15853
2023-02-12,23,9219,418,3893,1833,0,31,15394
2023-02-12,24,9218,162,4342,1645,0,23,15390
2023-02-13,1,9211,129,4322,1714,0,22,15398
2023-02-13,2,9215,129,4001,1795,0,22,15162
2023-02-13,3,9219,129,4375,1658,0,22,15403
2023-02-13,4,9220,155,4345,1730,0,22,15472
2023-02-13,5,9221,213,3761,1816,0,22,15033
2023-02-13,6,9227,304,3771,2033,0,22,15357
2023-02-13,7,9225,525,4159,2200,0,29,16138
2023-02-13,8,9228,535,4543,2778,13,33,17130
2023-02-13,9,9224,543,4547,2704,108,32,17158
2023-02-13,10,9219,551,4399,2507,197,33,16906
2023-02-13,11,9222,401,4717,2190,310,33,16873
2023-02-13,12,9223,379,4370,2231,372,32,16607
2023-02-13,13,9220,307,3939,2554,383,31,16434
2023-02-13,14,9217,329,3720,2654,354,32,16306
2023-02-13,15,9214,366,4198,3007,261,45,17091
2023-02-13,16,9211,376,5074,2682,220,75,17638
2023-02-13,17,9206,483,5562,2479,111,82,17923
2023-02-13,18,9203,728,5764,2319,12,83,18109
2023-02-13,19,9203,613,5705,2177,0,80,17778
2023-02-13,20,9200,627,5816,2026,0,81,17750
2023-02-13,21,9197,578,5529,2171,0,50,17525
2023-02-13,22,9233,280,5169,2063,0,29,16774
2023-02-13,23,9578,151,4141,1941,0,29,15840
2023-02-13,24,9725,132,4002,1691,0,22,15572
2023-02-14,1,9861,131,3972,1631,0,20,15615
2023-02-14,2,9858,131,4352,1542,0,20,15903
2023-02-14,3,9866,132,4528,1325,0,20,15871
2023-02-14,4,9868,131,4416,1091,0,20,15526
2023-02-14,5,9869,196,4563,846,0,20,15494
2023-02-14,6,9865,318,4774,527,0,21,15505
2023-02-14,7,9871,390,5280,579,0,28,16148
2023-02-14,8,9871,371,5557,846,15,32,16692
2023-02-14,9,9869,376,4424,1124,143,52,15988
2023-02-14,10,9869,356,4434,737,276,82,15754
2023-02-14,11,9864,356,4086,824,360,82,15572
2023-02-14,12,9867,356,3988,1259,403,84,15957
2023-02-14,13,9895,213,4167,1290,412,82,16059
2023-02-14,14,9939,130,3952,1457,414,82,15974
2023-02-14,15,9939,218,3965,1083,373,83,15661
2023-02-14,16,9937,295,4465,737,269,83,15786
2023-02-14,17,9936,363,4539,1518,107,82,16545
2023-02-14,18,9937,358,5105,2430,8,84,17922
2023-02-14,19,9940,356,4925,2891,0,43,18155
2023-02-14,20,9941,357,4601,3291,0,31,18221
2023-02-14,21,9935,357,4625,3509,0,30,18456
2023-02-14,22,9926,357,3812,3644,0,30,17769
2023-02-14,23,9927,221,3602,3662,0,30,17442
2023-02-14,24,9932,130,3596,3408,0,23,17089
2023-02-15,1,9938,131,3556,3019,0,21,16665
2023-02-15,2,9965,131,3617,2536,0,21,16270
2023-02-15,3,9964,131,3654,2311,0,21,16081
2023-02-15,4,9964,130,3654,2065,0,21,15834
2023-02-15,5,9963,130,3657,2269,0,21,16040
2023-02-15,6,9961,130,3588,3030,0,21,16730
2023-02-15,7,9963,130,3742,3791,0,26,17652
2023-02-15,8,9981,131,4190,3685,3,32,18022
2023-02-15,9,9985,130,4319,3506,25,33,17998
2023-02-15,10,9982,130,4395,3549,42,32,18130
2023-02-15,11,9977,129,4251,3897,122,32,18408
2023-02-15,12,9977,211,4096,3811,73,32,18200
2023-02-15,13,9979,288,4090,3350,95,32,17834
2023-02-15,14,9986,353,4017,2918,125,32,17431
2023-02-15,15,9989,468,4026,2544,183,32,17242
2023-02-15,16,9984,471,4030,2492,147,32,17156
2023-02-15,17,9989,473,4344,2865,88,32,17791
2023-02-15,18,9999,477,4568,3243,13,32,18332
2023-02-15,19,10004,477,4437,3903,0,32,18853
2023-02-15,20,10005,476,4544,3796,0,32,18853
2023-02-15,21,10003,475,4683,3980,0,31,19172
2023-02-15,22,10005,277,4406,3821,0,31,18540
2023-02-15,23,10004,127,3832,3692,0,31,17686
2023-02-15,24,9990,127,3763,3065,0,25,16970
2023-02-16,1,9993,127,3628,2478,0,20,16246
2023-02-16,2,10012,127,3646,2125,0,20,15930
2023-02-16,3,10005,127,3634,1727,0,20,15513
2023-02-16,4,10009,128,3943,1374,0,20,15474
2023-02-16,5,10014,148,4411,1067,0,20,15660
2023-02-16,6,10008,238,4373,948,0,29,15596
2023-02-16,7,10010,373,4955,733,0,62,16133
2023-02-16,8,10012,745,5932,465,2,94,17250
2023-02-16,9,10010,902,5887,413,30,147,17389
2023-02-16,10,10014,888,5650,549,85,86,17272
2023-02-16,11,10011,879,5414,662,103,75,17144
2023-02-16,12,10013,980,5329,782,103,74,17281
2023-02-16,13,10019,1161,4900,803,138,106,17127
2023-02-16,14,10023,1298,4565,1029,118,130,17163
2023-02-16,15,10026,1315,4479,1378,91,128,17417
2023-02-16,16,10025,1375,4418,1803,49,75,17745
2023-02-16,17,10019,1326,4922,1753,16,75,18111
2023-02-16,18,10020,1174,5666,1893,1,40,18794
2023-02-16,19,10020,1316,6005,1488,0,30,18859
2023-02-16,20,10021,1649,5583,1455,0,37,18745
2023-02-16,21,10018,1284,5401,1422,0,37,18162
2023-02-16,22,10014,969,4955,1435,0,29,17402
2023-02-16,23,9988,387,4811,1530,0,32,16748
2023-02-16,24,9995,173,4407,1559,0,22,16156
2023-02-17,1,10001,177,4360,1521,0,24,16083
2023-02-17,2,10015,267,4740,1439,0,31,16492
2023-02-17,3,10014,282,4468,1491,0,34,16289
2023-02-17,4,10012,189,3981,1477,0,33,15692
2023-02-17,5,10003,199,3971,1467,0,31,15671
2023-02-17,6,10005,207,3854,1476,0,29,15571
2023-02-17,7,10006,329,4367,1604,0,53,16359
2023-02-17,8,10006,715,4754,1697,1,76,17249
2023-02-17,9,10003,981,4909,1640,25,76,17634
2023-02-17,10,9998,1239,5006,1500,54,99,17896
2023-02-17,11,9999,1269,4970,1606,73,77,17994
2023-02-17,12,10005,1233,4756,1600,111,74,17779
2023-02-17,13,10009,1168,4765,1565,121,74,17702
2023-02-17,14,10009,1697,4779,1535,138,74,18232
2023-02-17,15,10016,1952,4833,1480,124,74,18479
2023-02-17,16,10017,2154,4797,1257,117,74,18416
2023-02-17,17,10020,2349,5491,1146,54,74,19134
2023-02-17,18,10015,2575,5853,1061,10,80,19594
2023-02-17,19,10019,2890,5872,905,0,108,19794
2023-02-17,20,10016,2943,5911,713,0,79,19662
2023-02-17,21,10017,2775,5783,641,0,33,19249
2023-02-17,22,10013,2466,5393,628,0,21,18521
2023-02-17,23,10018,2256,4738,923,0,21,17956
2023-02-17,24,10016,1426,3793,1402,0,21,16658
2023-02-18,1,10021,543,3500,2034,0,21,16119
2023-02-18,2,10019,368,3571,2386,0,21,16365
2023-02-18,3,10021,232,3705,2685,0,21,16664
2023-02-18,4,10022,164,3505,3008,0,21,16720
2023-02-18,5,10019,130,3403,3090,0,21,16663
2023-02-18,6,10019,130,3441,3284,0,21,16895
2023-02-18,7,10025,130,3554,3529,0,21,17259
2023-02-18,8,10024,130,3944,3573,9,21,17701
2023-02-18,9,10023,130,4165,3547,72,41,17978
2023-02-18,10,10021,130,4167,3628,168,71,18185
2023-02-18,11,10024,130,4491,3569,195,73,18482
2023-02-18,12,10019,133,4892,3522,222,73,18861
2023-02-18,13,10010,244,4661,3479,210,74,18678
2023-02-18,14,10014,242,4163,3449,208,75,18151
2023-02-18,15,10013,292,3922,3386,190,73,17876
2023-02-18,16,10012,661,3877,3255,147,69,18021
2023-02-18,17,10014,762,4091,2848,66,61,17842
2023-02-18,18,10009,804,4696,2540,12,64,18125
2023-02-18,19,10010,967,5115,2256,0,69,18417
2023-02-18,20,10007,967,4728,2256,0,66,18024
2023-02-18,21,10001,949,4633,2193,0,70,17846
2023-02-18,22,10008,688,4224,2311,0,75,17306
2023-02-18,23,10006,370,3758,2429,0,76,16639
2023-02-18,24,10007,336,3531,2618,0,76,16568
2023-02-19,1,10007,212,3348,2830,0,76,16473
2023-02-19,2,10016,132,3297,2822,0,76,16343
2023-02-19,3,10022,131,3357,2884,0,37,16431
2023-02-19,4,10016,131,3392,2982,0,23,16544
2023-02-19,5,9653,131,3311,3237,0,23,16355
2023-02-19,6,9505,132,3368,3262,0,23,16290
2023-02-19,7,9511,132,3489,3195,0,22,16349
2023-02-19,8,9507,133,3900,3685,5,12,17242
2023-02-19,9,9507,134,4149,3670,35,32,17527
2023-02-19,10,9511,133,4066,3910,95,72,17787
2023-02-19,11,9508,133,4038,3890,202,74,17845
2023-02-19,12,9510,212,3970,3711,260,74,17737
2023-02-19,13,9506,246,3886,3769,315,73,17795
2023-02-19,14,9507,296,3969,3389,288,75,17524
2023-02-19,15,9509,353,3867,3430,241,74,17474
2023-02-19,16,9509,354,3988,3332,143,74,17400
2023-02-19,17,9508,358,4199,3416,88,75,17644
2023-02-19,18,9510,360,4416,3575,14,74,17949
2023-02-19,19,9510,362,4406,3644,0,75,17997
2023-02-19,20,9508,361,4408,3540,0,75,17892
2023-02-19,21,9508,226,4432,3695,0,75,17936
2023-02-19,22,9507,133,4911,3538,0,74,18163
2023-02-19,23,9508,132,3975,3348,0,32,16995
2023-02-19,24,9511,132,4198,2982,0,21,16844
2023-02-20,1,9508,134,3723,2814,0,21,16200
2023-02-20,2,9512,133,3870,2505,0,21,16041
2023-02-20,3,9509,132,4120,2216,0,21,15998
2023-02-20,4,9504,132,4309,1874,0,21,15840
2023-02-20,5,9507,133,4056,1872,0,21,15589
2023-02-20,6,9504,132,3465,1941,0,30,15072
2023-02-20,7,9502,146,3712,1448,0,58,14866
2023-02-20,8,9500,154,3917,1353,7,72,15003
2023-02-20,9,9498,185,4044,1081,48,72,14928
2023-02-20,10,9493,197,4557,811,185,72,15315
2023-02-20,11,9492,213,4590,676,261,72,15304
2023-02-20,12,9493,282,4984,529,306,73,15667
2023-02-20,13,9491,351,4918,521,338,73,15692
2023-02-20,14,9490,627,4485,466,312,73,15453
2023-02-20,15,9495,910,4160,357,339,73,15334
2023-02-20,16,9494,1336,4442,234,174,73,15753
2023-02-20,17,9498,1500,4808,138,59,73,16076
2023-02-20,18,9496,1756,5698,198,17,73,17238
2023-02-20,19,9496,2161,5804,250,0,73,17784
2023-02-20,20,9499,1841,5761,357,0,73,17531
2023-02-20,21,9496,1760,5454,490,0,73,17273
2023-02-20,22,9464,1741,4706,711,0,73,16695
2023-02-20,23,8708,1736,4281,976,0,34,15735
2023-02-20,24,8709,1250,3867,1275,0,21,15122
2023-02-21,1,8713,610,3889,1591,0,21,14824
2023-02-21,2,8708,511,3606,2212,0,21,15058
2023-02-21,3,8714,510,3437,2659,0,21,15341
2023-02-21,4,8712,605,3472,2932,0,21,15742
2023-02-21,5,8714,938,3514,3004,0,21,16191
2023-02-21,6,8714,1549,3474,3031,0,36,16804
2023-02-21,7,8710,1746,4284,3173,0,68,17981
2023-02-21,8,8704,2208,4647,3192,13,76,18840
2023-02-21,9,8705,1856,4800,3435,40,73,18909
2023-02-21,10,8703,1814,4108,3626,99,74,18424
2023-02-21,11,8705,1833,3935,3602,175,73,18323
2023-02-21,12,8708,1529,4040,3343,192,74,17886
2023-02-21,13,8707,918,4060,4008,141,74,17908
2023-02-21,14,8707,719,3855,4427,119,74,17901
2023-02-21,15,8704,785,3901,4200,181,36,17807
2023-02-21,16,8706,1106,4003,3868,127,21,17831
2023-02-21,17,8707,1561,4385,3323,87,21,18084
2023-02-21,18,8707,1820,5569,3003,15,21,19135
2023-02-21,19,8704,2015,5783,2443,0,28,18973
2023-02-21,20,8704,1718,5926,2057,0,61,18466
2023-02-21,21,8704,1674,5860,1644,0,74,17956
2023-02-21,22,8704,1932,5635,1291,0,74,17636
2023-02-21,23,8705,1708,5024,942,0,74,16453
2023-02-21,24,8702,1308,4750,693,0,74,15527
2023-02-22,1,8708,1047,4771,441,0,74,15041
2023-02-22,2,8710,1045,4596,393,0,74,14818
2023-02-22,3,8710,1095,4371,325,0,74,14575
2023-02-22,4,8713,1341,4258,445,0,74,14831
2023-02-22,5,8713,2001,4025,697,0,74,15510
2023-02-22,6,8716,2470,3906,781,0,74,15947
2023-02-22,7,8713,2665,4285,1519,0,74,17256
2023-02-22,8,8714,2625,5073,1812,11,73,18308
2023-02-22,9,8718,2629,4715,1911,37,74,18084
2023-02-22,10,8717,2645,4807,2116,75,48,18408
2023-02-22,11,8714,2327,4424,2378,117,21,17981
2023-02-22,12,8709,2289,4615,2385,111,21,18130
2023-02-22,13,8699,2404,4602,2355,109,21,18190
2023-02-22,14,8694,2418,4551,2552,109,20,18344
2023-02-22,15,8688,1928,4668,2644,86,28,18042
2023-02-22,16,8701,1939,4807,2699,73,62,18281
2023-02-22,17,8696,2002,5144,2814,32,72,18760
2023-02-22,18,8696,2359,5553,2692,3,84,19387
2023-02-22,19,8691,2634,5417,2553,0,103,19398
2023-02-22,20,8695,2436,5394,2457,0,73,19055
2023-02-22,21,8696,2085,5203,2610,0,60,18654
2023-02-22,22,8697,2018,4837,2395,0,20,17967
2023-02-22,23,8697,1728,4261,2399,0,20,17105
2023-02-22,24,8698,1443,4207,2353,0,20,16721
2023-02-23,1,8696,1104,4278,2235,0,19,16332
2023-02-23,2,8699,1046,4117,2023,0,19,15904
2023-02-23,3,8700,790,4023,1879,0,19,15411
2023-02-23,4,8702,681,3997,1729,0,19,15128
2023-02-23,5,8705,871,3803,1689,0,19,15087
2023-02-23,6,8702,1659,3892,1604,0,31,15888
2023-02-23,7,8704,2422,4653,1551,0,64,17394
2023-02-23,8,8708,2786,5470,1365,3,107,18439
2023-02-23,9,8709,3460,5732,1173,25,101,19200
2023-02-23,10,8708,3890,5504,1101,48,12,19263
2023-02-23,11,8707,4245,5642,926,78,12,19610
2023-02-23,12,8704,4550,5284,966,85,12,19601
2023-02-23,13,8709,4768,5082,870,82,12,19523
2023-02-23,14,8711,4962,4897,920,77,12,19579
2023-02-23,15,8716,4976,5034,942,61,12,19741
2023-02-23,16,8708,4488,5207,1297,38,12,19750
2023-02-23,17,8699,3957,5348,1847,17,12,19880
2023-02-23,18,8699,3972,5523,2124,5,18,20341
2023-02-23,19,8710,3725,5679,2268,0,19,20401
2023-02-23,20,8709,3391,5883,2372,0,19,20374
2023-02-23,21,8708,3461,5211,2446,0,20,19846
2023-02-23,22,8708,2812,4813,2451,0,20,18804
2023-02-23,23,8706,2075,4494,2484,0,20,17779
2023-02-23,24,8709,2003,4382,2519,0,20,17633
2023-02-24,1,8709,1776,4295,2482,0,20,17282
2023-02-24,2,8712,1313,4176,2470,0,20,16691
2023-02-24,3,8711,1250,4153,2516,0,20,16650
2023-02-24,4,8708,1528,3996,2467,0,19,16718
2023-02-24,5,8708,1981,3897,2463,0,20,17069
2023-02-24,6,8703,2631,3794,2428,0,27,17583
2023-02-24,7,8700,3305,4917,2271,0,58,19251
2023-02-24,8,8699,4225,5332,1926,9,93,20284
2023-02-24,9,8697,4419,5441,1694,77,105,20433
2023-02-24,10,8701,4216,5445,1446,164,90,20062
2023-02-24,11,8701,3757,5124,1324,266,71,19243
2023-02-24,12,8699,3252,5045,1344,332,71,18743
2023-02-24,13,8697,2848,4939,1397,365,71,18317
2023-02-24,14,8697,2672,4266,1415,342,71,17463
2023-02-24,15,8698,2960,4165,1241,280,71,17415
2023-02-24,16,8699,3388,4431,619,194,71,17402
2023-02-24,17,8693,3630,5234,969,120,71,18717
2023-02-24,18,8704,4055,5985,818,22,71,19655
2023-02-24,19,8704,4907,6088,715,0,71,20485
2023-02-24,20,8702,4799,6122,658,0,71,20352
2023-02-24,21,8699,4632,6100,635,0,71,20137
2023-02-24,22,8699,4493,5767,579,0,73,19611
2023-02-24,23,8700,4438,5250,488,0,73,18949
2023-02-24,24,8694,4109,5085,495,0,72,18455
2023-02-25,1,8703,4056,4720,456,0,75,18010
2023-02-25,2,8703,3679,4248,471,0,73,17174
2023-02-25,3,8705,3599,4202,596,0,78,17180
2023-02-25,4,8704,3506,4231,446,0,76,16963
2023-02-25,5,8703,3558,4188,640,0,79,17168
2023-02-25,6,8703,3403,4154,1086,0,74,17420
2023-02-25,7,8704,3628,4766,1314,0,73,18485
2023-02-25,8,8702,3991,5250,1559,4,73,19579
2023-02-25,9,8704,4097,5346,1478,27,73,19725
2023-02-25,10,8701,4818,5405,863,58,74,19919
2023-02-25,11,8706,5371,4897,490,113,80,19657
2023-02-25,12,8709,4826,4854,401,181,73,19044
2023-02-25,13,8709,4728,4926,426,166,71,19026
2023-02-25,14,8707,4288,4830,544,123,73,18565
2023-02-25,15,8706,3642,4867,547,111,72,17945
2023-02-25,16,8709,3354,4563,497,125,71,17319
2023-02-25,17,8714,3465,5487,366,68,72,18172
2023-02-25,18,8715,4489,5657,374,13,71,19319
2023-02-25,19,8719,4157,5668,558,0,67,19169
2023-02-25,20,8720,3901,5782,670,0,22,19095
2023-02-25,21,8717,4179,5376,943,0,21,19236
2023-02-25,22,8716,3387,4537,1575,0,20,18235
2023-02-25,23,8713,3199,3850,2133,0,20,17915
2023-02-25,24,8715,2571,3140,2320,0,20,16766
2023-02-26,1,8714,1618,3690,2776,0,20,16818
2023-02-26,2,8715,941,3901,2850,0,20,16427
2023-02-26,3,8721,566,3313,3390,0,20,16010
2023-02-26,4,8715,505,3208,3695,0,20,16143
2023-02-26,5,8716,505,3381,3773,0,20,16395
2023-02-26,6,8713,578,3937,3444,0,20,16692
2023-02-26,7,8713,737,4384,3129,0,20,16983
2023-02-26,8,8718,844,4857,2581,8,27,17035
2023-02-26,9,8716,768,4741,2776,57,58,17116
2023-02-26,10,8713,933,4527,2765,145,66,17149
2023-02-26,11,8710,969,4213,2760,275,66,16993
2023-02-26,12,8715,1134,4383,2708,257,66,17263
2023-02-26,13,8721,1222,3806,2666,280,66,16761
2023-02-26,14,8720,1301,3729,2854,302,66,16972
2023-02-26,15,8721,1960,3729,2116,285,66,16877
2023-02-26,16,8721,2477,3725,1499,214,34,16670
2023-02-26,17,8716,2819,3944,1707,129,29,17344
2023-02-26,18,8714,2667,4763,1558,32,34,17768
2023-02-26,19,8712,2742,5414,1307,0,33,18208
2023-02-26,20,8712,2753,5490,972,0,26,17953
2023-02-26,21,8710,2719,5307,898,0,21,17655
2023-02-26,22,8710,2281,5046,743,0,19,16799
2023-02-26,23,8714,2268,4369,715,0,19,16085
2023-02-26,24,8714,1735,3878,856,0,19,15202
2023-02-27,1,8709,1570,4126,709,0,19,15133
2023-02-27,2,8713,1750,4358,573,0,19,15413
2023-02-27,3,8714,1607,4059,794,0,19,15193
2023-02-27,4,8712,1648,3493,1325,0,19,15197
2023-02-27,5,8714,2005,3352,1318,0,19,15408
2023-02-27,6,8718,2555,3512,1421,0,39,16245
2023-02-27,7,8714,2677,3874,2811,0,70,18146
2023-02-27,8,8716,2675,4324,3285,45,71,19116
2023-02-27,9,8716,2677,4207,3364,159,72,19195
2023-02-27,10,8710,2526,4006,2692,206,73,18213
2023-02-27,11,8713,2448,3934,3211,234,72,18612
2023-02-27,12,8710,1881,4133,3289,229,32,18274
2023-02-27,13,8706,1689,4542,3007,224,19,18187
2023-02-27,14,8707,2173,4615,2709,159,19,18382
2023-02-27,15,8704,2076,4331,2741,96,19,17967
2023-02-27,16,8700,1996,4329,2875,48,29,17977
2023-02-27,17,8705,2277,4524,3249,31,60,18846
2023-02-27,18,8712,2301,5216,3452,5,73,19759
2023-02-27,19,8712,2492,5508,3432,0,74,20218
2023-02-27,20,8715,2652,5240,3291,0,83,19981
2023-02-27,21,8717,2691,5043,2900,0,98,19449
2023-02-27,22,8709,2727,4428,2050,0,99,18013
2023-02-27,23,8713,2588,4043,1207,0,84,16635
2023-02-27,24,8707,1075,4284,973,0,88,15127
2023-02-28,1,8701,798,3963,855,0,78,14395
2023-02-28,2,8702,766,3880,717,0,74,14139
2023-02-28,3,8705,544,3472,729,0,74,13524
2023-02-28,4,8699,585,3333,1066,0,74,13757
2023-02-28,5,8709,957,3201,1367,0,74,14308
2023-02-28,6,8710,1514,3141,1649,0,74,15088
2023-02-28,7,8712,2113,3413,2314,0,73,16625
2023-02-28,8,8712,2378,4105,2770,0,76,18041
2023-02-28,9,8711,2403,4650,2915,3,76,18758
2023-02-28,10,8711,2459,4074,3071,11,76,18402
2023-02-28,11,8709,2432,4419,2888,20,74,18542
2023-02-28,12,8701,2451,4361,2715,28,36,18292
2023-02-28,13,8701,2356,4419,2713,42,20,18251
2023-02-28,14,8698,2477,4314,2403,61,21,17974
2023-02-28,15,8701,2256,4044,2133,84,20,17238
2023-02-28,16,8709,1836,4057,1713,75,28,16418
2023-02-28,17,8704,1983,4478,1338,47,62,16612
2023-02-28,18,8707,2600,5407,1178,12,77,17981
2023-02-28,19,8706,2747,5639,1022,0,78,18192
2023-02-28,20,8702,2195,5455,1163,0,75,17590
2023-02-28,21,8705,2138,4872,1304,0,75,17094
2023-02-28,22,8703,1814,4381,1498,0,77,16473
2023-02-28,23,8697,1670,3648,1311,0,75,15401
2023-02-28,24,8696,998,3641,1589,0,75,14999
2023-03-01,1,8703,898,3975,1241,0,33,14850
2023-03-01,2,8704,1036,3984,1058,0,21,14803
2023-03-01,3,8709,1105,3664,1052,0,21,14551
2023-03-01,4,8706,1433,3429,1030,0,21,14619
2023-03-01,5,8705,1929,3472,796,0,22,14924
2023-03-01,6,8706,1802,3741,966,0,27,15242
2023-03-01,7,8704,2213,4279,1440,0,56,16692
2023-03-01,8,8703,2471,4536,1680,9,74,17473
2023-03-01,9,8701,2366,4402,1978,36,78,17561
2023-03-01,10,8701,2379,4189,1812,73,79,17233
2023-03-01,11,8703,1841,4257,1688,158,82,16729
2023-03-01,12,8695,1729,4857,1110,204,83,16678
2023-03-01,13,8692,2391,4764,780,252,88,16967
2023-03-01,14,8692,2294,4672,558,241,80,16537
2023-03-01,15,8701,2460,4604,391,238,77,16471
2023-03-01,16,8702,2812,4704,367,192,70,16847
2023-03-01,17,8703,2813,4911,402,120,69,17018
2023-03-01,18,8708,2891,5457,364,30,70,17520
2023-03-01,19,8705,3209,5523,375,0,70,17882
2023-03-01,20,8703,2896,5609,511,0,67,17786
2023-03-01,21,8707,2567,5509,778,0,66,17627
2023-03-01,22,8657,2075,4768,905,0,68,16473
2023-03-01,23,7916,2493,4589,632,0,75,15705
2023-03-01,24,7913,2113,4383,419,0,78,14906
2023-03-02,1,7917,1695,4185,275,0,77,14149
2023-03-02,2,7914,1373,4183,308,0,76,13854
2023-03-02,3,7913,1364,4156,359,0,45,13837
2023-03-02,4,7917,1487,4173,371,0,26,13974
2023-03-02,5,7912,1827,3921,425,0,25,14110
2023-03-02,6,7917,2045,3781,493,0,26,14262
2023-03-02,7,7913,2566,4675,664,0,31,15849
2023-03-02,8,7909,3516,5121,566,13,64,17189
2023-03-02,9,7912,3825,5310,550,57,91,17745
2023-03-02,10,7912,3715,5147,610,96,93,17573
2023-03-02,11,7900,2891,5051,638,141,93,16714
2023-03-02,12,7897,2818,4876,633,201,92,16517
2023-03-02,13,7896,3380,4478,496,241,93,16584
2023-03-02,14,7892,3388,4343,518,235,92,16468
2023-03-02,15,7894,3433,4151,541,183,86,16288
2023-03-02,16,7890,3042,4342,655,162,85,16176
2023-03-02,17,7890,3171,4885,910,105,83,17044
2023-03-02,18,7892,3243,5271,957,34,81,17478
2023-03-02,19,7895,3800,5749,659,0,77,18180
2023-03-02,20,7899,3957,5546,486,0,77,17965
2023-03-02,21,7900,3946,5390,575,0,78,17889
2023-03-02,22,7898,3328,4908,700,0,77,16911
2023-03-02,23,7900,2802,4514,602,0,89,15907
2023-03-02,24,7907,1940,4212,628,0,75,14762
2023-03-03,1,7910,1505,3976,782,0,72,14245
2023-03-03,2,7902,1340,3782,846,0,74,13944
2023-03-03,3,7906,1422,3973,904,0,33,14238
2023-03-03,4,7905,1711,3931,939,0,20,14506
2023-03-03,5,7909,2167,3666,1187,0,20,14949
2023-03-03,6,7908,2392,3215,1417,0,20,14952
2023-03-03,7,7906,2781,3925,1850,0,25,16487
2023-03-03,8,7909,2793,4591,2054,47,55,17449
2023-03-03,9,7901,2795,4357,1933,138,85,17209
2023-03-03,10,7913,2488,4385,1818,200,95,16899
2023-03-03,11,7916,1740,4543,1941,245,95,16480
2023-03-03,12,7915,1387,4731,2341,253,97,16724
2023-03-03,13,7911,1376,4409,2880,210,95,16881
2023-03-03,14,7911,1382,4180,3169,176,95,16913
2023-03-03,15,7903,1235,4165,3440,139,96,16978
2023-03-03,16,7900,1292,4243,3597,95,98,17225
2023-03-03,17,7896,1190,4759,3656,47,95,17643
2023-03-03,18,7901,1134,4992,3795,8,52,17882
2023-03-03,19,7901,1210,4805,3859,0,40,17815
2023-03-03,20,7898,1123,4684,4027,0,39,17771
2023-03-03,21,7898,1124,5003,3683,0,40,17748
2023-03-03,22,7902,950,4642,3598,0,39,17131
2023-03-03,23,7901,540,4069,3748,0,41,16299
2023-03-03,24,7901,201,3431,3730,0,42,15305
2023-03-04,1,7898,130,3366,3709,0,42,15145
2023-03-04,2,7893,131,3565,3575,0,38,15202
2023-03-04,3,7893,130,3705,3508,0,38,15274
2023-03-04,4,7895,130,3873,3443,0,37,15378
2023-03-04,5,7890,285,3796,3446,0,41,15458
2023-03-04,6,7893,361,3583,3424,0,66,15327
2023-03-04,7,7896,696,3699,3016,0,96,15403
2023-03-04,8,7894,1296,4190,2401,3,101,15885
2023-03-04,9,7896,1988,4519,1599,27,111,16140
2023-03-04,10,7895,2259,4797,1247,81,119,16398
2023-03-04,11,7891,2413,4790,860,138,119,16211
2023-03-04,12,7886,2237,4685,668,184,114,15774
2023-03-04,13,7886,2220,4459,537,221,110,15433
2023-03-04,14,7886,2239,3923,477,251,105,14881
2023-03-04,15,7885,2265,3866,265,247,102,14630
2023-03-04,16,7884,2288,3965,215,189,97,14638
2023-03-04,17,7886,2351,4370,396,115,94,15212
2023-03-04,18,7885,2462,4849,475,34,109,15814
2023-03-04,19,7885,2665,5645,474,0,105,16774
2023-03-04,20,7883,2801,5568,657,0,105,17014
2023-03-04,21,7881,2887,5126,930,0,108,16932
2023-03-04,22,7886,2892,4917,1002,0,97,16794
2023-03-04,23,7889,2895,4072,1116,0,62,16034
2023-03-04,24,7907,2642,3831,1078,0,50,15508
2023-03-05,1,7923,2084,3883,1074,0,48,15012
2023-03-05,2,7930,1780,4050,886,0,48,14694
2023-03-05,3,7942,1615,4044,893,0,47,14541
2023-03-05,4,7952,1544,4010,1048,0,47,14601
2023-03-05,5,7967,1532,3635,1371,0,46,14551
2023-03-05,6,7984,1532,3465,1547,0,44,14572
2023-03-05,7,7998,1701,3618,1617,0,40,14974
2023-03-05,8,7997,1870,4181,1629,15,60,15752
2023-03-05,9,7992,1959,4601,1417,74,100,16143
2023-03-05,10,7993,1958,4575,1268,103,101,15998
2023-03-05,11,8005,1796,4717,906,211,101,15736
2023-03-05,12,8020,1761,4568,772,306,107,15534
2023-03-05,13,8042,1831,4277,772,275,97,15294
2023-03-05,14,8064,1926,4297,819,271,55,15432
2023-03-05,15,8074,1723,4234,722,251,56,15060
2023-03-05,16,8083,1983,4380,601,175,56,15278
2023-03-05,17,8110,2517,4709,508,81,55,15980
2023-03-05,18,8116,2893,5517,445,29,57,17057
2023-03-05,19,8114,3826,5825,340,0,57,18162
2023-03-05,20,8112,4089,5620,388,0,53,18262
2023-03-05,21,8106,3735,5085,452,0,42,17420
2023-03-05,22,8106,3324,4904,489,0,35,16858
2023-03-05,23,8134,3052,4317,542,0,32,16077
2023-03-05,24,8135,2397,4171,595,0,19,15317
2023-03-06,1,8152,1953,4085,776,0,19,14985
2023-03-06,2,8151,1734,3781,894,0,19,14579
2023-03-06,3,8161,1562,3963,776,0,18,14480
2023-03-06,4,8178,1580,3992,808,0,19,14577
2023-03-06,5,8180,1523,3454,1105,0,42,14304
2023-03-06,6,8210,1519,3491,975,0,76,14271
2023-03-06,7,8271,1519,4139,1382,2,90,15403
2023-03-06,8,8271,1530,4910,1698,38,87,16534
2023-03-06,9,8278,1520,4461,1977,129,89,16454
2023-03-06,10,8270,1627,4492,1997,206,80,16672
2023-03-06,11,8250,1605,4370,1822,231,88,16366
2023-03-06,12,8257,1136,4371,1992,212,91,16059
2023-03-06,13,8259,1131,3934,2085,212,90,15711
2023-03-06,14,8377,976,4020,2330,208,89,16000
2023-03-06,15,8491,1090,4376,2385,211,87,16640
2023-03-06,16,8534,1078,4082,2548,162,84,16488
2023-03-06,17,8530,1336,4615,2410,62,83,17036
2023-03-06,18,8481,1394,5029,2475,12,77,17468
2023-03-06,19,8491,1515,4920,2431,0,35,17392
2023-03-06,20,8491,1519,5010,2131,0,26,17177
2023-03-06,21,8490,1534,4758,2075,0,29,16886
2023-03-06,22,8481,1538,4395,2075,0,26,16515
2023-03-06,23,8484,1529,4130,2058,0,26,16227
2023-03-06,24,8490,676,3529,2124,0,25,14844
2023-03-07,1,8482,362,3668,2101,0,28,14641
2023-03-07,2,8502,175,3670,2445,0,33,14825
2023-03-07,3,8681,228,3400,2324,0,28,14661
2023-03-07,4,8720,384,3359,2463,0,27,14953
2023-03-07,5,8738,612,3457,2120,0,34,14961
2023-03-07,6,8887,774,3634,2218,0,32,15545
2023-03-07,7,8884,941,3872,2673,2,33,16405
2023-03-07,8,8887,1007,4227,2872,41,28,17062
2023-03-07,9,8890,994,4230,2733,130,23,17000
2023-03-07,10,8891,1132,4256,2239,230,21,16769
2023-03-07,11,8893,836,4075,2923,321,20,17068
2023-03-07,12,8895,834,3566,3542,405,20,17262
2023-03-07,13,8895,866,3499,3503,416,20,17199
2023-03-07,14,8894,905,3472,3371,415,20,17077
2023-03-07,15,8900,1029,3584,3336,347,20,17216
2023-03-07,16,8899,1327,3701,3021,283,20,17251
2023-03-07,17,8897,1152,4240,3042,168,20,17519
2023-03-07,18,8892,820,4907,3369,54,20,18062
2023-03-07,19,8957,774,4985,3275,1,20,18012
2023-03-07,20,9029,770,5185,3255,0,20,18259
2023-03-07,21,9030,658,5098,3230,0,20,18036
2023-03-07,22,9023,733,4910,3048,0,20,17734
2023-03-07,23,9027,661,4186,3082,0,20,16976
2023-03-07,24,9031,227,3777,3215,0,20,16270
2023-03-08,1,9030,147,3394,3120,0,20,15711
2023-03-08,2,9032,160,3522,3168,0,20,15902
2023-03-08,3,9033,186,3727,2959,0,20,15925
2023-03-08,4,9035,262,3651,2849,0,20,15817
2023-03-08,5,9055,542,3281,2609,0,20,15507
2023-03-08,6,9059,552,3386,2498,0,20,15515
2023-03-08,7,9055,548,4052,2524,0,29,16208
2023-03-08,8,9060,586,4707,2644,48,55,17100
2023-03-08,9,9063,637,4547,2588,178,68,17081
2023-03-08,10,9066,543,4095,2278,322,71,16375
2023-03-08,11,9064,330,3903,1817,409,69,15592
2023-03-08,12,9060,137,3846,1790,416,69,15318
2023-03-08,13,9073,220,3775,2012,401,69,15550
2023-03-08,14,9073,397,3701,1624,387,69,15251
2023-03-08,15,9076,681,3802,1589,418,69,15635
2023-03-08,16,9072,987,4085,1259,354,69,15826
2023-03-08,17,9061,1080,4116,1388,221,70,15936
2023-03-08,18,9071,1084,4611,1980,65,34,16845
2023-03-08,19,9072,1085,5005,2160,1,20,17343
2023-03-08,20,9076,1077,5259,2064,0,20,17496
2023-03-08,21,9077,977,5138,1917,0,20,17129
2023-03-08,22,9077,624,4861,1739,0,20,16321
2023-03-08,23,9080,453,4563,1440,0,20,15556
2023-03-08,24,9091,417,4126,1306,0,20,14960
2023-03-09,1,9088,502,3561,1224,0,20,14395
2023-03-09,2,9097,552,3891,1201,0,20,14761
2023-03-09,3,9098,765,4006,1256,0,20,15145
2023-03-09,4,9091,885,3676,1290,0,20,14962
2023-03-09,5,9089,1285,3409,1266,0,19,15068
2023-03-09,6,9091,1384,3478,1149,0,26,15128
2023-03-09,7,9096,1551,4546,1145,2,57,16397
2023-03-09,8,9098,1783,4991,1014,76,78,17040
2023-03-09,9,9098,1701,4957,614,132,76,16578
2023-03-09,10,9104,1603,4467,509,202,69,15954
2023-03-09,11,9106,1662,4173,475,276,70,15762
2023-03-09,12,9109,1362,4268,573,278,34,15624
2023-03-09,13,9107,1380,3969,617,333,20,15426
2023-03-09,14,9118,1542,3849,511,404,20,15444
2023-03-09,15,9118,1771,3838,427,393,20,15567
2023-03-09,16,9115,2141,3911,220,294,20,15701
2023-03-09,17,9116,2140,4195,491,188,28,16158
2023-03-09,18,9117,2143,4933,577,47,60,16877
2023-03-09,19,9118,2181,5409,738,0,70,17516
2023-03-09,20,9135,2184,5350,1007,0,73,17749
2023-03-09,21,9136,1826,5175,1092,0,74,17303
2023-03-09,22,9133,1328,5160,1192,0,74,16887
2023-03-09,23,9136,1143,4359,1226,0,74,15938
2023-03-09,24,9137,635,4021,1110,0,72,14975
2023-03-10,1,9136,557,4099,1013,0,74,14879
2023-03-10,2,9137,589,4001,1114,0,34,14875
2023-03-10,3,9130,405,3898,1271,0,20,14724
2023-03-10,4,9129,380,3691,1840,0,19,15059
2023-03-10,5,9152,428,3328,1486,0,20,14414
2023-03-10,6,9157,666,3313,1916,0,21,15073
2023-03-10,7,9152,733,3595,2750,2,21,16253
2023-03-10,8,9158,733,3967,3053,23,20,16954
2023-03-10,9,9158,734,4406,3034,67,20,17419
2023-03-10,10,9160,842,4546,2919,121,20,17608
2023-03-10,11,9155,1172,4253,2899,131,20,17630
2023-03-10,12,9153,1190,4249,2779,135,20,17526
2023-03-10,13,9156,1312,4172,2649,155,31,17475
2023-03-10,14,9013,1132,4002,2801,144,58,17150
2023-03-10,15,8687,1166,4086,2932,123,72,17066
2023-03-10,16,8656,1320,3845,3095,91,72,17079
2023-03-10,17,8657,1304,4160,3528,53,72,17774
2023-03-10,18,8655,1300,4567,3453,11,71,18057
2023-03-10,19,8659,1303,5043,3072,0,74,18151
2023-03-10,20,8658,1305,5111,2770,0,75,17919
2023-03-10,21,8658,963,4992,2864,0,74,17551
2023-03-10,22,8652,754,4658,2863,0,73,17000
2023-03-10,23,8656,836,4274,2649,0,88,16503
2023-03-10,24,8655,617,3831,2637,0,78,15818
2023-03-11,1,8653,563,3765,2436,0,78,15495
2023-03-11,2,8653,597,3886,2070,0,79,15285
2023-03-11,3,8658,687,3864,1933,0,95,15237
2023-03-11,4,8660,604,3794,1925,0,79,15062
2023-03-11,5,8658,865,3774,2001,0,94,15392
2023-03-11,6,8661,1129,3392,1988,0,74,15244
2023-03-11,7,8670,1154,3791,1821,0,76,15512
2023-03-11,8,8668,1174,4265,1584,10,70,15771
2023-03-11,9,8666,1345,4503,1355,47,68,15984
2023-03-11,10,8667,1680,4436,1313,135,69,16300
2023-03-11,11,8670,1847,3906,1167,249,70,15909
2023-03-11,12,8676,2012,3785,988,338,70,15869
2023-03-11,13,8673,1761,3680,816,365,70,15365
2023-03-11,14,8673,2101,3466,440,339,85,15104
2023-03-11,15,8676,2169,3509,675,298,79,15406
2023-03-11,16,8686,2173,3779,616,266,36,15556
2023-03-11,17,8682,2193,4284,702,162,33,16056
2023-03-11,18,8679,2218,5190,652,44,20,16803
2023-03-11,19,8658,2515,5785,589,0,19,17566
2023-03-11,20,8655,2769,5634,501,0,19,17578
2023-03-11,21,8661,2617,5360,515,0,19,17172
2023-03-11,22,8672,2284,5053,510,0,19,16538
2023-03-11,23,8677,1710,4471,582,0,20,15460
2023-03-11,24,8682,1558,4066,596,0,20,14922
2023-03-12,1,8691,1383,3892,484,0,20,14470
2023-03-12,2,8708,1389,4256,368,0,20,14741
2023-03-12,3,8713,1437,4278,307,0,20,14755
2023-03-12,4,8706,1488,4261,301,0,20,14776
2023-03-12,5,8701,1476,4270,313,0,20,14780
2023-03-12,6,8700,1492,4134,368,0,36,14730
2023-03-12,7,8703,1541,4251,384,5,66,14950
2023-03-12,8,8704,1544,4060,432,55,69,14864
2023-03-12,9,8698,1545,4623,413,123,71,15473
2023-03-12,10,8701,1541,5056,297,185,69,15849
2023-03-12,11,8701,1541,5012,246,196,70,15766
2023-03-12,12,8699,1541,4678,260,236,34,15448
2023-03-12,13,8701,1645,4527,241,246,19,15379
2023-03-12,14,8700,2176,4411,184,198,19,15688
2023-03-12,15,8703,2333,4423,163,143,19,15784
2023-03-12,16,8702,2413,4494,174,102,30,15915
2023-03-12,17,8700,2305,5027,190,53,53,16328
2023-03-12,18,8699,2267,5326,234,14,52,16592
2023-03-12,19,8703,2269,5640,244,0,50,16906
2023-03-12,20,8714,2270,5316,294,0,51,16645
2023-03-12,21,8553,2214,5061,283,0,51,16162
2023-03-12,22,7892,2508,4941,241,0,51,15633
2023-03-12,23,7887,1897,4714,273,0,51,14822
2023-03-12,24,7888,1438,4591,277,0,51,14245
2023-03-13,1,7893,1279,4135,262,0,53,13622
2023-03-13,2,7892,1253,4320,261,0,52,13778
2023-03-13,3,7892,1433,4281,297,0,51,13954
2023-03-13,4,7890,1895,4146,377,0,51,14359
2023-03-13,5,7894,2470,3724,384,0,51,14523
2023-03-13,6,7892,2828,4441,424,0,51,15636
2023-03-13,7,7888,3766,4893,399,0,51,16997
2023-03-13,8,7884,3876,5336,442,4,55,17597
2023-03-13,9,7882,3909,5374,458,20,57,17700
2023-03-13,10,7888,3989,5526,453,42,74,17972
2023-03-13,11,7893,3777,5191,427,97,56,17441
2023-03-13,12,7890,3224,5028,357,138,53,16690
2023-03-13,13,7890,3141,4900,413,139,53,16536
2023-03-13,14,7890,2881,4757,697,128,53,16406
2023-03-13,15,7886,2492,4633,1034,121,53,16219
2023-03-13,16,7883,2270,4582,1491,105,53,16384
2023-03-13,17,7884,2151,5086,1825,63,53,17062
2023-03-13,18,7885,2169,5426,1939,21,53,17493
2023-03-13,19,7882,2255,5494,1962,0,53,17646
2023-03-13,20,7884,2180,5250,2130,0,53,17497
2023-03-13,21,7884,2139,4943,2062,0,53,17081
2023-03-13,22,7886,2020,4295,2064,0,52,16317
2023-03-13,23,7887,1770,4092,1951,0,52,15752
2023-03-13,24,7888,1078,3956,1983,0,54,14959
2023-03-14,1,7888,429,4056,2156,0,13,14542
2023-03-14,2,7889,439,4324,2111,0,0,14763
2023-03-14,3,7885,359,4137,2238,0,0,14619
2023-03-14,4,7888,470,4049,2511,0,0,14918
2023-03-14,5,7891,866,3901,2684,0,0,15342
2023-03-14,6,7886,940,4121,2882,0,0,15829
2023-03-14,7,7887,1213,4718,2923,0,6,16747
2023-03-14,8,7887,1433,5017,3011,13,38,17399
2023-03-14,9,7887,1636,4918,3154,51,53,17699
2023-03-14,10,7888,1595,4494,3272,112,53,17414
2023-03-14,11,7891,1194,4375,3393,188,53,17094
2023-03-14,12,7896,999,4117,3373,203,54,16642
2023-03-14,13,7888,1049,3966,2989,275,15,16182
2023-03-14,14,7886,1114,3899,3055,326,0,16280
2023-03-14,15,7888,1271,3928,3006,280,0,16373
2023-03-14,16,7885,1415,4051,3190,198,0,16739
2023-03-14,17,7882,1611,4271,3490,115,0,17369
2023-03-14,18,7885,1479,4671,3277,38,0,17350
2023-03-14,19,7881,1392,5401,3031,1,0,17706
2023-03-14,20,7880,1550,5568,2822,0,0,17820
2023-03-14,21,7883,1238,5268,2592,0,0,16981
2023-03-14,22,7879,1036,5012,2545,0,0,16472
2023-03-14,23,7880,937,4469,2587,0,0,15873
2023-03-14,24,7884,541,4033,2654,0,0,15112
2023-03-15,1,7890,505,3983,2508,0,0,14886
2023-03-15,2,7890,521,4145,2344,0,0,14900
2023-03-15,3,7894,690,4056,2203,0,0,14843
2023-03-15,4,7895,1110,3974,2186,0,0,15165
2023-03-15,5,7894,1727,3467,2192,0,0,15280
2023-03-15,6,7893,2030,4238,1900,0,0,16061
2023-03-15,7,7896,2685,5018,1612,3,0,17214
2023-03-15,8,7899,2910,5302,1213,103,0,17427
2023-03-15,9,7899,2684,5235,695,262,0,16775
2023-03-15,10,7896,2251,5028,491,383,0,16049
2023-03-15,11,7895,1725,5055,426,403,0,15504
2023-03-15,12,7899,1176,5023,407,424,0,14929
2023-03-15,13,7902,1180,4651,548,418,0,14699
2023-03-15,14,7899,1402,4303,839,413,0,14856
2023-03-15,15,7900,1464,4099,911,399,0,14773
2023-03-15,16,7898,1470,4124,1193,324,0,15009
2023-03-15,17,7906,1469,4511,1268,200,0,15354
2023-03-15,18,7904,1474,5134,1310,61,0,15883
2023-03-15,19,7903,1471,5265,1690,1,0,16330
2023-03-15,20,7903,1473,5061,2032,0,0,16469
2023-03-15,21,7899,1219,4987,2288,0,0,16393
2023-03-15,22,7897,675,4610,2655,0,0,15837
2023-03-15,23,7897,504,4035,2740,0,0,15176
2023-03-15,24,7901,504,4061,2620,0,0,15086
2023-03-16,1,7897,564,4093,2649,0,0,15203
2023-03-16,2,7899,508,3965,2600,0,0,14972
2023-03-16,3,7898,637,3848,2491,0,4,14878
2023-03-16,4,7895,839,3911,2239,0,0,14884
2023-03-16,5,7899,1213,3641,2112,0,14,14879
2023-03-16,6,7895,1416,3676,2181,0,45,15213
2023-03-16,7,7900,1704,4301,2158,2,53,16118
2023-03-16,8,7900,1772,4534,2128,36,51,16421
2023-03-16,9,7897,1946,4912,1922,107,51,16835
2023-03-16,10,7898,1734,4698,1946,217,51,16544
2023-03-16,11,7900,1317,4776,2082,242,52,16369
2023-03-16,12,7897,1242,4559,2188,248,52,16186
2023-03-16,13,7895,1194,4318,2341,336,21,16105
2023-03-16,14,7890,1276,4011,2341,305,0,15823
2023-03-16,15,7894,1474,3891,2428,277,0,15964
2023-03-16,16,7891,1926,4061,2406,190,0,16474
2023-03-16,17,7896,1952,4337,2374,87,0,16646
2023-03-16,18,7898,1958,4608,2167,29,0,16660
2023-03-16,19,7897,1967,4682,2412,0,0,16958
2023-03-16,20,7900,1925,4623,2476,0,0,16924
2023-03-16,21,7900,1104,4627,3003,0,0,16634
2023-03-16,22,7901,531,4234,3280,0,0,15946
2023-03-16,23,7900,164,4010,3252,0,0,15326
2023-03-16,24,7892,133,3500,3313,0,0,14838
2023-03-17,1,7882,132,3386,3485,0,0,14885
2023-03-17,2,7880,133,3133,3508,0,0,14654
2023-03-17,3,7881,231,3062,3485,0,0,14659
2023-03-17,4,7891,372,3250,3628,0,0,15141
2023-03-17,5,7890,539,2968,3556,0,0,14953
2023-03-17,6,7895,540,3112,3510,0,22,15079
2023-03-17,7,7897,540,3911,3750,0,51,16149
2023-03-17,8,7900,542,4227,4107,3,51,16830
2023-03-17,9,7899,542,4494,4183,12,53,17183
2023-03-17,10,7901,677,4712,4173,30,60,17553
2023-03-17,11,7901,875,4672,4153,42,61,17704
2023-03-17,12,7900,742,4443,4232,48,61,17426
2023-03-17,13,7903,588,4123,4347,49,55,17065
2023-03-17,14,7899,215,3914,4300,47,54,16429
2023-03-17,15,7901,129,3743,4447,52,51,16323
2023-03-17,16,7898,214,4123,4509,36,50,16830
2023-03-17,17,7898,284,4311,4337,23,50,16903
2023-03-17,18,7893,357,4442,4407,11,12,17122
2023-03-17,19,7893,353,4614,4172,0,0,17032
2023-03-17,20,7895,354,4863,3875,0,0,16987
2023-03-17,21,7897,356,4876,3716,0,0,16845
2023-03-17,22,7898,355,4425,3712,0,0,16390
2023-03-17,23,7902,355,4067,3756,0,0,16080
2023-03-17,24,7902,218,4063,3580,0,0,15763
2023-03-18,1,7902,125,4078,3330,0,0,15435
2023-03-18,2,7907,131,4133,3000,0,0,15171
2023-03-18,3,7907,191,4123,2993,0,0,15214
2023-03-18,4,7911,133,3378,3347,0,0,14769
2023-03-18,5,7908,124,3320,3018,0,0,14370
2023-03-18,6,7908,125,3609,3002,0,0,14644
2023-03-18,7,7908,125,4045,3074,2,0,15154
2023-03-18,8,7903,125,3980,3387,50,0,15445
2023-03-18,9,7905,125,3944,3637,149,0,15760
2023-03-18,10,7901,125,3825,3624,243,0,15718
2023-03-18,11,7907,125,4016,3855,281,0,16184
2023-03-18,12,7902,161,4376,3912,248,0,16599
2023-03-18,13,7897,198,3840,4152,201,16,16304
2023-03-18,14,7893,126,3665,4278,217,47,16226
2023-03-18,15,7901,126,3533,4232,213,51,16056
2023-03-18,16,7903,126,3666,4194,173,51,16113
2023-03-18,17,7904,126,4084,4343,118,51,16626
2023-03-18,18,7902,126,4240,4319,40,51,16678
2023-03-18,19,7902,127,4610,4270,3,26,16938
2023-03-18,20,7909,126,4686,4226,1,0,16948
2023-03-18,21,7908,126,4529,4267,1,0,16831
2023-03-18,22,7911,126,4233,4324,1,0,16595
2023-03-18,23,7916,126,3765,4344,1,0,16152
2023-03-18,24,7913,127,3896,4355,1,0,16292
2023-03-19,1,7913,127,3954,4402,1,0,16397
2023-03-19,2,7910,127,3679,4360,1,0,16077
2023-03-19,3,7915,128,3844,4213,1,0,16101
2023-03-19,4,7915,182,4044,3931,1,0,16073
2023-03-19,5,7911,203,4008,3798,1,0,15921
2023-03-19,6,7908,287,4096,3799,1,0,16091
2023-03-19,7,7904,311,3887,3807,7,0,15916
2023-03-19,8,7903,334,4385,3690,76,0,16388
2023-03-19,9,7911,331,4081,3771,182,0,16276
2023-03-19,10,7910,331,3929,3519,289,0,15978
2023-03-19,11,7913,331,3964,3515,315,0,16038
2023-03-19,12,7904,332,4033,3687,343,2,16301
2023-03-19,13,7900,332,3753,3515,353,1,15854
2023-03-19,14,7902,333,3557,3458,353,9,15612
2023-03-19,15,7901,337,3624,3536,357,42,15797
2023-03-19,16,7903,416,3768,3569,300,52,16008
2023-03-19,17,7904,489,3985,3694,204,51,16327
2023-03-19,18,7900,545,4080,3832,70,51,16478
2023-03-19,19,7901,548,4442,3827,4,52,16774
2023-03-19,20,7901,548,4680,3921,0,53,17103
2023-03-19,21,7909,548,4264,4065,0,53,16839
2023-03-19,22,7908,552,3870,4160,0,53,16543
2023-03-19,23,7914,405,3426,4107,0,53,15905
2023-03-19,24,7912,267,3218,4271,0,10,15678
2023-03-20,1,7911,245,3512,4265,0,0,15933
2023-03-20,2,7909,245,3577,4238,0,0,15969
2023-03-20,3,7932,241,3529,4198,0,0,15900
2023-03-20,4,8103,306,3169,4053,0,0,15631
2023-03-20,5,8098,366,3287,3889,0,6,15646
2023-03-20,6,8097,449,3910,3896,0,37,16389
2023-03-20,7,8097,504,4717,3875,9,53,17255
2023-03-20,8,8095,581,4781,3697,101,54,17309
2023-03-20,9,8090,527,4299,3576,249,52,16793
2023-03-20,10,8101,565,3929,3545,370,53,16563
2023-03-20,11,8168,560,3912,3405,415,17,16477
2023-03-20,12,8322,407,3706,3844,403,0,16682
2023-03-20,13,8447,400,3731,3951,400,0,16929
2023-03-20,14,8578,467,3550,3959,395,0,16949
2023-03-20,15,8578,469,3444,3843,375,6,16715
2023-03-20,16,8573,526,3574,3566,308,37,16584
2023-03-20,17,8584,621,3961,3714,190,51,17121
2023-03-20,18,8593,574,4575,3596,55,51,17444
2023-03-20,19,8591,554,4590,3502,3,51,17291
2023-03-20,20,8594,419,4842,3422,0,52,17329
2023-03-20,21,8587,326,4564,3368,0,53,16898
2023-03-20,22,8575,374,4328,3118,0,51,16446
2023-03-20,23,8584,464,4320,2470,0,52,15890
2023-03-20,24,8588,484,4067,2445,0,55,15639
2023-03-21,1,8596,292,3429,2482,0,7,14806
2023-03-21,2,8688,340,3229,2649,0,0,14906
2023-03-21,3,8695,421,3192,2624,0,0,14932
2023-03-21,4,8693,640,3248,2268,0,0,14849
2023-03-21,5,8693,1019,3244,2381,0,9,15346
2023-03-21,6,8696,1804,3678,2271,0,43,16492
2023-03-21,7,8699,2536,4414,2020,4,56,17729
2023-03-21,8,8697,2718,4704,1682,55,60,17916
2023-03-21,9,8660,2058,4525,1252,171,54,16720
2023-03-21,10,8631,1963,3907,970,292,53,15816
2023-03-21,11,8506,1900,4085,814,375,53,15733
2023-03-21,12,8665,1356,3996,753,387,55,15212
2023-03-21,13,8707,1041,3976,868,330,54,14976
2023-03-21,14,8703,1271,3960,838,337,53,15162
2023-03-21,15,8702,1414,4156,699,292,53,15316
2023-03-21,16,8696,1473,4201,705,212,54,15341
2023-03-21,17,8703,1627,4457,539,144,53,15523
2023-03-21,18,8703,1608,4988,525,51,53,15928
2023-03-21,19,8707,1664,5307,705,3,53,16439
2023-03-21,20,8706,1727,5229,1016,0,53,16731
2023-03-21,21,8709,1564,4492,1293,0,53,16111
2023-03-21,22,8710,1067,4164,1539,0,53,15533
2023-03-21,23,8706,377,3774,1601,0,53,14511
2023-03-21,24,8703,291,3788,1853,0,53,14688
2023-03-22,1,8705,258,3536,2141,0,53,14693
2023-03-22,2,8705,252,3161,2415,0,53,14586
2023-03-22,3,8712,252,3181,2484,0,53,14682
2023-03-22,4,8711,371,3559,2204,0,53,14898
2023-03-22,5,8709,669,3979,1747,0,66,15170
2023-03-22,6,8710,1521,4109,1557,0,77,15974
2023-03-22,7,8707,1846,4336,1477,7,62,16435
2023-03-22,8,8708,1802,4104,1844,51,55,16564
2023-03-22,9,8705,1699,4264,1843,126,51,16688
2023-03-22,10,8709,1757,4298,1874,202,61,16901
2023-03-22,11,8706,1650,4147,2086,237,59,16885
2023-03-22,12,8704,1124,4078,2411,193,57,16567
2023-03-22,13,8708,914,3901,2556,199,52,16330
2023-03-22,14,8709,1007,4048,2560,183,49,16556
2023-03-22,15,8707,933,4005,2702,120,50,16517
2023-03-22,16,8704,1095,4216,2707,59,55,16836
2023-03-22,17,8704,1114,4137,2755,27,53,16790
2023-03-22,18,8704,785,4030,2632,8,50,16209
2023-03-22,19,8706,756,4438,2608,0,50,16558
2023-03-22,20,8704,751,4311,2503,0,50,16319
2023-03-22,21,8705,747,4073,2688,0,50,16263
2023-03-22,22,8710,240,3683,2760,0,50,15443
2023-03-22,23,8709,126,3326,2688,0,50,14899
2023-03-22,24,8701,126,3141,2865,0,14,14847
2023-03-23,1,8706,126,3423,2851,0,0,15106
2023-03-23,2,8706,127,3501,2939,0,0,15273
2023-03-23,3,8707,128,3338,2793,0,0,14966
2023-03-23,4,8710,331,3453,2726,0,0,15220
2023-03-23,5,8620,581,3302,2545,0,0,15048
2023-03-23,6,8606,1050,3753,2139,0,0,15548
2023-03-23,7,8607,1647,4185,2102,0,0,16541
2023-03-23,8,8607,1595,4308,2477,4,0,16991
2023-03-23,9,8606,1423,4321,2454,16,0,16820
2023-03-23,10,8609,1388,4399,2421,34,0,16851
2023-03-23,11,8644,1572,4613,1854,82,1,16766
2023-03-23,12,8717,1505,4371,1914,87,0,16594
2023-03-23,13,8722,1346,4641,2117,74,0,16900
2023-03-23,14,8722,1298,4472,2410,85,0,16987
2023-03-23,15,8720,1304,4092,2524,83,1,16724
2023-03-23,16,8718,1409,4033,2428,75,0,16663
2023-03-23,17,8717,1690,3942,2291,67,4,16711
2023-03-23,18,8715,1720,4224,2076,35,39,16809
2023-03-23,19,8721,1849,4788,1771,2,54,17185
2023-03-23,20,8726,2110,4681,1678,0,51,17246
2023-03-23,21,8722,1774,4630,1524,0,52,16702
2023-03-23,22,8720,1217,4348,1420,0,53,15758
2023-03-23,23,8724,732,3946,1312,0,52,14766
2023-03-23,24,8725,626,3682,1265,0,51,14349
2023-03-24,1,8728,526,3332,1219,0,51,13856
2023-03-24,2,8726,511,3267,1059,0,51,13614
2023-03-24,3,8731,806,3290,816,0,47,13690
2023-03-24,4,8736,1161,3218,653,0,0,13768
2023-03-24,5,8733,1820,3533,550,0,0,14636
2023-03-24,6,8732,2036,4255,535,0,0,15558
2023-03-24,7,8731,2392,5034,518,6,0,16681
2023-03-24,8,8726,2542,5116,505,57,17,16963
2023-03-24,9,8724,2425,4996,566,145,48,16904
2023-03-24,10,8718,2074,4699,443,266,53,16253
2023-03-24,11,8722,1942,4192,324,339,53,15572
2023-03-24,12,8724,1643,4199,232,362,53,15213
2023-03-24,13,8728,1585,3972,181,399,53,14918
2023-03-24,14,8726,1746,3663,225,394,53,14807
2023-03-24,15,8731,1616,3566,347,368,53,14681
2023-03-24,16,8730,1423,3899,353,255,53,14713
2023-03-24,17,8732,1671,4475,387,169,53,15487
2023-03-24,18,8735,1570,4832,456,60,53,15706
2023-03-24,19,8734,1702,5256,550,3,57,16302
2023-03-24,20,8737,1637,5004,704,0,53,16135
2023-03-24,21,8737,1638,4988,938,0,51,16352
2023-03-24,22,8731,1208,4306,1366,0,51,15662
2023-03-24,23,8730,800,3600,1597,0,51,14778
2023-03-24,24,8730,201,3318,2118,0,51,14418
2023-03-25,1,8735,126,3046,2579,0,51,14537
2023-03-25,2,8736,126,3024,2632,0,51,14569
2023-03-25,3,8732,126,3009,3170,0,14,15051
2023-03-25,4,8734,127,3027,3743,0,0,15631
2023-03-25,5,8726,126,3171,3751,0,0,15774
2023-03-25,6,8730,126,3226,3683,0,0,15765
2023-03-25,7,8727,127,3554,4062,3,0,16473
2023-03-25,8,8725,141,3948,3993,22,20,16849
2023-03-25,9,8725,236,4225,4017,37,55,17295
2023-03-25,10,8725,538,4693,3680,58,80,17774
2023-03-25,11,8721,722,4538,3565,74,88,17708
2023-03-25,12,8727,530,3595,3727,63,54,16696
2023-03-25,13,8728,411,3392,3490,57,53,16131
2023-03-25,14,8731,335,3273,3893,92,12,16336
2023-03-25,15,8733,431,3761,3705,103,0,16733
2023-03-25,16,8735,427,4136,3441,45,0,16784
2023-03-25,17,8733,522,4078,3555,66,0,16954
2023-03-25,18,8738,406,3593,3038,22,0,15797
2023-03-25,19,8737,130,3760,2855,1,0,15483
2023-03-25,20,8738,126,3751,2670,0,0,15285
2023-03-25,21,8735,125,3727,2897,0,0,15484
2023-03-25,22,8278,125,3432,3735,0,0,15570
2023-03-25,23,8290,126,3072,3722,0,0,15210
2023-03-25,24,8308,125,3001,3837,0,0,15271
2023-03-26,1,8308,126,2918,3623,0,0,14975
2023-03-26,2,8308,126,2913,3741,0,0,15088
2023-03-26,3,8306,126,2750,3703,0,0,14885
2023-03-26,4,8309,126,2776,3653,0,0,14864
2023-03-26,5,8315,142,2793,3453,0,0,14703
2023-03-26,6,8312,212,2893,3047,0,0,14464
2023-03-26,7,8316,282,3591,3030,4,0,15223
2023-03-26,8,8383,351,3692,2779,58,0,15263
2023-03-26,9,8457,351,4430,2508,154,0,15900
2023-03-26,10,8467,357,4226,2347,232,0,15629
2023-03-26,11,8466,373,4139,2117,273,0,15368
2023-03-26,12,8468,386,4190,1818,314,0,15176
2023-03-26,13,8463,660,4525,1693,364,0,15705
2023-03-26,14,8456,1054,3863,1767,399,0,15539
2023-03-26,15,8508,1556,3495,1211,413,0,15183
2023-03-26,16,8619,1748,3639,1360,336,5,15707
2023-03-26,17,8639,1724,3951,1277,197,34,15822
2023-03-26,18,8644,1726,3980,1257,71,53,15731
2023-03-26,19,8641,1729,4222,1034,6,53,15685
2023-03-26,20,8640,1723,4731,653,0,53,15800
2023-03-26,21,8641,1501,4810,386,0,51,15389
2023-03-26,22,8641,1060,4746,347,0,46,14840
2023-03-26,23,8639,901,3922,385,0,15,13862
2023-03-26,24,8641,900,3736,336,0,0,13613
2023-03-27,1,8644,901,3637,382,0,0,13564
2023-03-27,2,8650,901,3739,471,0,0,13761
2023-03-27,3,8694,1001,3641,521,0,0,13857
2023-03-27,4,8712,1202,3027,709,0,0,13650
2023-03-27,5,8713,1489,3372,756,0,0,14330
2023-03-27,6,8715,2107,4332,921,0,0,16075
2023-03-27,7,8714,2231,4694,1139,8,0,16786
2023-03-27,8,8718,2295,4698,1122,39,0,16872
2023-03-27,9,8719,2817,4671,876,59,0,17142
2023-03-27,10,8724,3182,4597,827,75,0,17405
2023-03-27,11,8721,3148,4526,950,105,0,17450
2023-03-27,12,8720,3030,4366,996,109,0,17221
2023-03-27,13,8715,2974,4202,1129,107,0,17127
2023-03-27,14,8714,2799,4148,1160,117,0,16938
2023-03-27,15,8712,2603,4091,1400,133,0,16939
2023-03-27,16,8708,2284,4075,1766,90,0,16923
2023-03-27,17,8707,2553,4339,1619,63,0,17281
2023-03-27,18,8708,2730,4619,1293,30,0,17380
2023-03-27,19,8710,3138,4843,967,2,0,17660
2023-03-27,20,8708,2889,4641,768,0,0,17006
2023-03-27,21,8706,2772,4678,669,0,0,16825
2023-03-27,22,8708,2017,4315,695,0,0,15735
2023-03-27,23,8710,1821,3933,598,0,0,15062
2023-03-27,24,8712,1492,3685,682,0,0,14571
2023-03-28,1,8714,1442,3457,740,0,0,14353
2023-03-28,2,8015,1563,3684,645,0,0,13907
2023-03-28,3,7908,1960,3632,606,0,0,14106
2023-03-28,4,7896,2148,3658,507,0,0,14209
2023-03-28,5,7883,2970,3801,372,0,0,15026
2023-03-28,6,7887,3288,4360,347,0,0,15882
2023-03-28,7,7889,3650,5167,336,13,0,17055
2023-03-28,8,7892,3479,5111,288,91,10,16871
2023-03-28,9,7890,3124,5025,114,174,1,16328
2023-03-28,10,7891,2708,4729,68,277,0,15673
2023-03-28,11,7890,2488,4184,279,340,0,15181
2023-03-28,12,7887,1886,4074,410,305,0,14562
2023-03-28,13,7888,2128,3948,452,305,1,14722
2023-03-28,14,7887,2126,3779,443,297,0,14532
2023-03-28,15,7888,2100,3629,398,265,8,14288
2023-03-28,16,7886,2259,3911,304,247,32,14639
2023-03-28,17,7887,2372,4345,386,168,51,15209
2023-03-28,18,7887,2343,4774,433,60,52,15549
2023-03-28,19,7893,2375,4983,601,6,54,15912
2023-03-28,20,7890,2400,5107,1019,0,54,16470
2023-03-28,21,7887,2101,4416,1484,0,54,15942
2023-03-28,22,7868,1479,3917,1810,0,24,15098
2023-03-28,23,7888,1202,3524,2079,0,3,14696
2023-03-28,24,7885,975,3086,2269,0,0,14215
2023-03-29,1,7879,933,3449,2181,0,0,14442
2023-03-29,2,7881,943,3743,1959,0,0,14526
2023-03-29,3,7876,1047,3662,1778,0,0,14363
2023-03-29,4,7887,1253,3212,1915,0,0,14267
2023-03-29,5,7902,1562,3327,1806,0,0,14597
2023-03-29,6,7902,1569,3845,2518,0,0,15834
2023-03-29,7,7904,1568,4467,2885,14,0,16838
2023-03-29,8,7903,1399,4324,3000,87,0,16713
2023-03-29,9,7906,1183,3942,3317,175,0,16523
2023-03-29,10,7906,1146,3789,3578,250,0,16669
2023-03-29,11,7902,658,3367,3559,267,0,15753
2023-03-29,12,7906,518,3250,3967,280,0,15921
2023-03-29,13,7911,543,3777,4386,219,0,16836
2023-03-29,14,7912,670,3874,4437,148,0,17041
2023-03-29,15,7899,803,3708,4426,97,0,16933
2023-03-29,16,7883,970,3889,4406,78,22,17248
2023-03-29,17,7897,1137,3706,4315,55,48,17158
2023-03-29,18,7901,1138,3850,4038,38,52,17017
2023-03-29,19,7902,1211,4502,3751,3,53,17422
2023-03-29,20,7898,1470,5002,3096,0,69,17535
2023-03-29,21,7901,1757,4544,2615,0,77,16894
2023-03-29,22,7900,1543,4097,2345,0,56,15941
2023-03-29,23,7896,1234,3930,2142,0,9,15211
2023-03-29,24,7999,927,3700,2079,0,0,14705
2023-03-30,1,8130,1043,3368,1862,0,0,14403
2023-03-30,2,8208,1258,3217,1628,0,0,14311
2023-03-30,3,8300,1678,3411,1309,0,0,14698
2023-03-30,4,8313,2373,3563,878,0,0,15127
2023-03-30,5,8365,2877,3798,506,0,8,15554
2023-03-30,6,8483,3437,4274,341,0,39,16574
2023-03-30,7,8486,3823,4902,343,11,66,17631
2023-03-30,8,8490,3709,4898,326,76,64,17563
2023-03-30,9,8490,3017,4778,351,200,52,16888
2023-03-30,10,8492,2373,4148,487,307,51,15858
2023-03-30,11,8492,1495,4408,782,356,15,15548
2023-03-30,12,8491,1196,4066,1105,386,0,15244
2023-03-30,13,8489,1146,3542,1287,396,0,14860
2023-03-30,14,8491,1148,3591,1321,392,0,14943
2023-03-30,15,8496,1258,3444,1053,379,2,14632
2023-03-30,16,8498,1479,3511,1131,327,0,14946
2023-03-30,17,8525,1770,4038,1210,202,0,15745
2023-03-30,18,8634,1772,4220,1238,81,0,15945
2023-03-30,19,8671,1873,5006,1117,6,0,16673
2023-03-30,20,8669,2116,5270,1070,0,0,17125
2023-03-30,21,8668,2029,4899,1265,0,0,16861
2023-03-30,22,8676,1674,4215,1367,0,0,15932
2023-03-30,23,8678,1131,3896,1365,0,0,15070
2023-03-30,24,8679,687,3746,1425,0,0,14537
2023-03-31,1,8691,426,3236,1704,0,0,14057
2023-03-31,2,8696,368,3359,1517,0,0,13940
2023-03-31,3,8694,420,3577,1387,0,0,14078
2023-03-31,4,8683,703,3850,1249,0,0,14485
2023-03-31,5,8692,1018,3139,1600,0,0,14449
2023-03-31,6,8696,1017,3386,2161,0,0,15260
2023-03-31,7,8696,1107,3835,2529,11,0,16178
2023-03-31,8,8704,1111,4120,3044,30,0,17009
2023-03-31,9,8712,1111,3885,3371,62,0,17141
2023-03-31,10,8714,1114,4454,3267,73,0,17622
2023-03-31,11,8713,1243,4494,2939,80,0,17469
2023-03-31,12,8717,1239,4452,2995,91,0,17494
2023-03-31,13,8715,717,4224,3069,95,0,16820
2023-03-31,14,8715,668,4276,3250,81,0,16990
2023-03-31,15,8712,550,4695,3021,65,0,17043
2023-03-31,16,8715,930,4719,2695,58,0,17117
2023-03-31,17,8719,845,4493,2522,40,0,16619
2023-03-31,18,8717,452,4265,2439,14,0,15887
2023-03-31,19,8719,335,4506,2383,2,0,15945
2023-03-31,20,8714,321,3956,2285,0,0,15276
2023-03-31,21,8712,169,4021,2496,0,0,15398
2023-03-31,22,8710,139,3678,2603,0,0,15130
2023-03-31,23,8711,139,3038,2908,0,0,14796
2023-03-31,24,8710,140,2929,3000,0,0,14779
2023-04-01,1,8715,138,2959,3204,0,0,15016
2023-04-01,2,8723,137,3138,3343,0,0,15341
2023-04-01,3,8721,137,3404,3446,0,0,15708
2023-04-01,4,8716,140,3618,3590,0,0,16064
2023-04-01,5,8715,140,3389,3811,0,0,16055
2023-04-01,6,8719,139,3175,3855,0,0,15888
2023-04-01,7,8722,139,3725,3587,8,0,16181
2023-04-01,8,8724,140,4078,3939,75,0,16956
2023-04-01,9,8724,140,4744,3310,250,0,17168
2023-04-01,10,8714,176,5167,2410,322,0,16789
2023-04-01,11,8715,383,4626,2154,286,0,16164
2023-04-01,12,8717,302,3163,2145,315,0,14642
2023-04-01,13,8721,258,3133,2312,183,0,14607
2023-04-01,14,8719,140,3020,2530,181,0,14590
2023-04-01,15,8718,140,3058,3198,180,0,15294
2023-04-01,16,8721,127,3441,3658,82,0,16029
2023-04-01,17,8710,126,3726,3916,55,0,16533
2023-04-01,18,8710,126,4380,3763,21,0,17000
2023-04-01,19,8704,126,4667,3796,2,0,17295
2023-04-01,20,8705,127,4215,3883,0,0,16930
2023-04-01,21,8712,126,3868,3747,0,0,16453
2023-04-01,22,8706,126,3973,3613,0,0,16418
2023-04-01,23,8710,126,3634,3426,0,0,15896
2023-04-01,24,8705,126,3600,2955,0,0,15386
2023-04-02,1,8698,235,4169,2209,0,0,15311
2023-04-02,2,8704,366,4336,1530,0,0,14936
2023-04-02,3,8708,265,3921,1279,0,0,14173
2023-04-02,4,8708,276,3728,1130,0,0,13842
2023-04-02,5,8712,402,3817,942,0,0,13873
2023-04-02,6,8709,695,4062,675,0,0,14141
2023-04-02,7,8711,839,4585,492,19,0,14646
2023-04-02,8,8711,645,4517,383,123,0,14379
2023-04-02,9,8713,539,4221,400,251,0,14124
2023-04-02,10,8713,539,3767,422,396,0,13837
2023-04-02,11,8714,564,4079,568,419,0,14344
2023-04-02,12,8707,243,3994,641,419,0,14004
2023-04-02,13,8710,243,3719,811,412,0,13895
2023-04-02,14,8712,527,3176,970,410,0,13795
2023-04-02,15,8697,946,3047,886,405,9,13990
2023-04-02,16,8675,959,3281,936,353,42,14246
2023-04-02,17,8677,1001,3862,970,236,53,14799
2023-04-02,18,8675,1097,4543,1160,82,53,15610
2023-04-02,19,8674,1139,4802,1420,19,52,16106
2023-04-02,20,8669,1139,4931,1916,5,53,16713
2023-04-02,21,8669,1137,4255,2122,0,53,16236
2023-04-02,22,8672,465,4176,2268,0,53,15634
2023-04-02,23,8677,327,3818,2334,0,12,15168
2023-04-02,24,8676,279,3786,2497,0,0,15238
2023-04-03,1,8674,136,3961,2618,0,0,15389
2023-04-03,2,8675,165,3622,3049,0,0,15511
2023-04-03,3,8695,143,3133,3616,0,0,15587
2023-04-03,4,8692,141,3142,3265,0,0,15240
2023-04-03,5,8693,163,3094,3275,0,0,15225
2023-04-03,6,8695,287,4036,3454,0,1,16473
2023-04-03,7,8693,571,4717,3323,13,12,17329
2023-04-03,8,8691,514,4581,3506,83,17,17392
2023-04-03,9,8697,491,4721,3323,159,13,17404
2023-04-03,10,8697,479,4841,2691,238,17,16963
2023-04-03,11,8698,740,4928,2307,284,20,16977
2023-04-03,12,8697,1117,4404,2088,264,21,16591
2023-04-03,13,8695,1270,3898,1860,280,16,16019
2023-04-03,14,8695,1362,3848,1439,234,19,15597
2023-04-03,15,8691,1816,4110,1295,216,26,16154
2023-04-03,16,8696,2141,4338,1259,114,53,16601
2023-04-03,17,8693,1847,4530,1215,60,68,16413
2023-04-03,18,8696,1723,4946,1150,15,68,16598
2023-04-03,19,8694,1516,4850,1265,2,59,16386
2023-04-03,20,8692,1565,5145,887,0,51,16340
2023-04-03,21,8681,1574,4610,860,0,54,15779
2023-04-03,22,8683,1779,4275,691,0,72,15500
2023-04-03,23,8685,1371,4053,605,0,52,14766
2023-04-03,24,8682,877,3816,695,0,51,14121
2023-04-04,1,8679,711,3849,561,0,51,13851
2023-04-04,2,8680,923,3551,596,0,51,13801
2023-04-04,3,8680,1143,3435,608,0,51,13917
2023-04-04,4,8685,1426,3570,589,0,51,14321
2023-04-04,5,8683,2021,3775,481,0,51,15011
2023-04-04,6,8682,3055,4178,430,0,53,16398
2023-04-04,7,8681,3764,4538,528,5,66,17582
2023-04-04,8,8673,3449,4372,654,27,69,17244
2023-04-04,9,8675,3233,4230,646,75,68,16927
2023-04-04,10,8671,2631,4161,587,193,62,16305
2023-04-04,11,8675,2294,4052,609,237,71,15938
2023-04-04,12,8674,2176,3862,697,274,69,15752
2023-04-04,13,8679,2021,3681,1065,276,69,15791
2023-04-04,14,8675,1595,3858,1272,248,69,15717
2023-04-04,15,8674,998,3771,1595,215,69,15322
2023-04-04,16,8673,824,3923,1716,175,72,15383
2023-04-04,17,8666,1304,4258,1861,154,31,16274
2023-04-04,18,8671,1248,4247,2457,76,14,16713
2023-04-04,19,8673,1077,4271,3004,33,1,17059
2023-04-04,20,8669,972,4356,3457,13,1,17468
2023-04-04,21,8669,648,3959,3680,0,0,16956
2023-04-04,22,8667,581,3635,3897,0,0,16780
2023-04-04,23,8669,554,3242,3910,0,0,16375
2023-04-04,24,8664,219,3179,4118,0,0,16180
2023-04-05,1,8664,137,2991,4125,0,0,15917
2023-04-05,2,8667,136,3064,4054,0,0,15921
2023-04-05,3,8666,137,3206,3944,0,0,15953
2023-04-05,4,8667,147,3688,3892,0,0,16394
2023-04-05,5,8669,238,3747,3738,0,0,16392
2023-04-05,6,8661,468,4183,3431,0,0,16743
2023-04-05,7,8654,838,4556,3303,2,8,17361
2023-04-05,8,8654,806,4436,3347,23,12,17278
2023-04-05,9,8659,798,4602,3251,50,36,17396
2023-04-05,10,8656,1376,4568,2934,54,78,17666
2023-04-05,11,8657,2039,4519,2773,74,101,18163
2023-04-05,12,8661,2273,4585,2907,64,81,18571
2023-04-05,13,8664,1826,4399,2849,58,77,17873
2023-04-05,14,8663,1808,4601,2411,67,72,17622
2023-04-05,15,8667,2137,4547,1656,39,77,17123
2023-04-05,16,8670,1678,4405,1933,43,70,16799
2023-04-05,17,8668,1666,4626,2322,20,71,17373
2023-04-05,18,8669,1512,4225,2737,17,62,17222
2023-04-05,19,8674,1634,4102,2783,1,57,17251
2023-04-05,20,8667,1343,3839,3626,0,54,17529
2023-04-05,21,8667,1219,3571,3511,0,16,16984
2023-04-05,22,8661,835,3559,3639,0,0,16694
2023-04-05,23,8663,198,3797,3872,0,0,16530
2023-04-05,24,8662,138,3490,3894,0,0,16184
2023-04-06,1,8661,138,3019,3820,0,0,15638
2023-04-06,2,8665,138,2952,3364,0,0,15119
2023-04-06,3,8659,139,3269,3130,0,0,15197
2023-04-06,4,8656,247,3894,2922,0,0,15719
2023-04-06,5,8652,442,4001,2412,0,0,15507
2023-04-06,6,8646,591,4244,2376,0,0,15857
2023-04-06,7,8646,568,4565,2420,12,9,16220
2023-04-06,8,8643,569,4643,2362,53,13,16283
2023-04-06,9,8643,572,4471,2477,99,6,16268
2023-04-06,10,8640,563,4457,2545,172,8,16385
2023-04-06,11,8642,556,4018,2401,222,11,15850
2023-04-06,12,8642,221,3574,2907,254,10,15608
2023-04-06,13,8644,136,3718,3298,246,11,16053
2023-04-06,14,8648,137,3629,3555,262,14,16245
2023-04-06,15,8589,138,3367,3283,249,23,15649
2023-04-06,16,8640,138,3467,3115,196,52,15608
2023-04-06,17,8642,139,3763,2972,135,67,15718
2023-04-06,18,8641,138,4049,3003,61,63,15955
2023-04-06,19,8637,139,4147,3326,11,54,16314
2023-04-06,20,8638,140,4328,3706,3,53,16868
2023-04-06,21,8639,139,4406,3709,3,22,16918
2023-04-06,22,8634,139,4494,3284,2,0,16553
2023-04-06,23,8634,139,4048,3307,0,0,16128
2023-04-06,24,8639,139,3483,3506,0,0,15767
2023-04-07,1,8634,139,3174,3260,0,0,15207
2023-04-07,2,8634,139,3536,2977,0,0,15286
2023-04-07,3,8630,139,3952,2846,0,0,15567
2023-04-07,4,8626,194,4152,2789,0,0,15761
2023-04-07,5,8627,145,3721,2964,0,0,15457
2023-04-07,6,8627,139,4154,2960,0,0,15880
2023-04-07,7,8624,139,4367,2577,22,0,15729
2023-04-07,8,8620,139,4400,2217,143,0,15519
2023-04-07,9,8617,139,4016,2186,276,0,15234
2023-04-07,10,8621,139,3773,2039,371,0,14943
2023-04-07,11,8624,146,4437,1617,415,0,15239
2023-04-07,12,8624,256,4672,1334,412,0,15298
2023-04-07,13,8621,189,4199,1249,416,0,14674
2023-04-07,14,8622,270,3870,1270,415,0,14447
2023-04-07,15,8621,408,3530,1208,394,14,14175
2023-04-07,16,8620,677,3768,983,364,46,14458
2023-04-07,17,8613,924,4451,975,242,51,15256
2023-04-07,18,8613,1024,4751,829,104,51,15372
2023-04-07,19,8615,1084,5201,548,10,51,15509
2023-04-07,20,8607,1194,5450,384,0,50,15685
2023-04-07,21,8607,1276,5357,385,0,48,15673
2023-04-07,22,8604,1272,4959,389,0,0,15224
2023-04-07,23,8604,516,4516,338,0,0,13974
2023-04-07,24,8606,293,4157,253,0,0,13309
2023-04-08,1,8626,236,4289,217,0,0,13368
2023-04-08,2,8632,147,4057,247,0,0,13083
2023-04-08,3,8626,138,4028,218,0,0,13010
2023-04-08,4,8631,172,4100,190,0,0,13093
2023-04-08,5,8634,190,4289,219,0,13,13345
2023-04-08,6,8635,190,4701,301,0,49,13876
2023-04-08,7,8634,186,4808,602,32,53,14315
2023-04-08,8,8628,174,4306,815,155,52,14130
2023-04-08,9,8630,163,4075,980,296,51,14195
2023-04-08,10,8632,156,4215,726,392,51,14172
2023-04-08,11,8628,223,4570,308,402,53,14184
2023-04-08,12,8624,283,4296,294,421,53,13971
2023-04-08,13,8641,215,4095,310,416,52,13729
2023-04-08,14,8645,242,3983,268,402,52,13592
2023-04-08,15,8646,515,3701,259,366,51,13538
2023-04-08,16,8645,774,3782,281,299,51,13832
2023-04-08,17,8646,874,4349,236,179,51,14335
2023-04-08,18,8649,1093,4919,148,90,51,14950
2023-04-08,19,8647,1258,5086,92,28,51,15162
2023-04-08,20,8647,1336,5166,96,9,53,15307
2023-04-08,21,8641,1328,5037,120,0,50,15176
2023-04-08,22,8640,985,4756,187,0,50,14618
2023-04-08,23,8652,637,4126,259,0,50,13724
2023-04-08,24,8665,616,4066,312,0,51,13710
2023-04-09,1,8667,229,4063,325,0,19,13303
2023-04-09,2,8663,192,4124,328,0,0,13307
2023-04-09,3,8668,171,3986,400,0,0,13225
2023-04-09,4,8668,160,3983,434,0,0,13245
2023-04-09,5,8670,175,4040,434,0,0,13319
2023-04-09,6,8670,280,4751,449,0,11,14161
2023-04-09,7,8666,242,4755,534,35,49,14281
2023-04-09,8,8680,162,4540,571,157,51,14161
2023-04-09,9,8683,149,4565,386,299,51,14133
2023-04-09,10,8685,148,4627,388,397,51,14296
2023-04-09,11,8688,148,4313,390,424,51,14014
2023-04-09,12,8685,206,4344,429,430,34,14128
2023-04-09,13,8677,224,4064,472,430,0,13867
2023-04-09,14,8673,272,3887,468,428,0,13728
2023-04-09,15,8673,495,3845,444,419,0,13876
2023-04-09,16,8671,781,4160,451,365,0,14428
2023-04-09,17,8683,898,4105,471,236,0,14393
2023-04-09,18,8696,919,4497,485,110,0,14707
2023-04-09,19,8697,1064,4722,568,12,0,15063
2023-04-09,20,8695,1099,4901,879,1,0,15575
2023-04-09,21,8696,1150,4747,1183,1,0,15777
2023-04-09,22,8695,1065,4346,1444,0,0,15550
2023-04-09,23,8695,896,3802,1689,0,0,15082
2023-04-09,24,8693,317,3563,1888,0,0,14461
2023-04-10,1,8695,144,3478,2007,0,0,14324
2023-04-10,2,8714,142,3336,2042,0,0,14234
2023-04-10,3,8725,141,3698,1910,0,0,14474
2023-04-10,4,8721,319,3857,1757,0,0,14654
2023-04-10,5,8718,629,3816,1818,0,11,14992
2023-04-10,6,8722,964,4131,1784,1,42,15644
2023-04-10,7,8720,968,4514,1698,32,63,15995
2023-04-10,8,8721,881,4688,1469,146,68,15973
2023-04-10,9,8718,878,4525,1152,262,61,15596
2023-04-10,10,8716,868,4513,1118,363,62,15640
2023-04-10,11,8717,867,4170,1129,397,66,15346
2023-04-10,12,8719,1198,4172,1187,418,73,15767
2023-04-10,13,8716,997,4081,1303,420,42,15559
2023-04-10,14,8717,890,3941,1325,414,19,15306
2023-04-10,15,8716,873,4098,1392,393,18,15490
2023-04-10,16,8718,873,4498,1560,319,16,15984
2023-04-10,17,8719,927,4761,1659,206,20,16292
2023-04-10,18,8717,943,4822,1685,78,21,16266
2023-04-10,19,8719,1026,5188,1540,11,7,16491
2023-04-10,20,8717,1351,5102,1649,0,0,16819
2023-04-10,21,8715,1177,4780,1906,0,0,16578
2023-04-10,22,8712,888,4161,2336,0,0,16097
2023-04-10,23,8718,623,3395,2694,0,0,15430
2023-04-10,24,8718,220,3362,2878,0,0,15178
2023-04-11,1,8724,243,3187,3234,0,0,15388
2023-04-11,2,8726,299,3212,2909,0,0,15146
2023-04-11,3,8726,299,3075,3304,0,0,15404
2023-04-11,4,8722,299,3143,3266,0,0,15430
2023-04-11,5,8720,299,3199,3283,0,0,15501
2023-04-11,6,8723,362,3830,3471,0,1,16387
2023-04-11,7,8724,504,4159,3825,21,17,17250
2023-04-11,8,8722,908,3927,3278,93,18,16946
2023-04-11,9,8721,1002,3751,3103,195,12,16784
2023-04-11,10,8718,992,3802,2733,282,11,16538
2023-04-11,11,8725,977,3404,3074,348,18,16546
2023-04-11,12,8726,894,3497,3162,358,24,16661
2023-04-11,13,8648,342,3599,3443,309,24,16365
2023-04-11,14,8723,141,3544,3805,222,24,16459
2023-04-11,15,8713,224,3609,3618,224,24,16412
2023-04-11,16,8708,303,3752,3257,194,27,16241
2023-04-11,17,8720,380,4014,3300,107,27,16548
2023-04-11,18,8719,379,4443,3474,50,22,17087
2023-04-11,19,8718,371,4725,3325,17,6,17162
2023-04-11,20,8715,371,4811,3341,10,0,17248
2023-04-11,21,8719,366,4805,3238,5,0,17133
2023-04-11,22,8723,365,4101,2961,0,0,16150
2023-04-11,23,8722,226,3995,2368,0,0,15311
2023-04-11,24,8719,139,3534,2543,0,0,14935
2023-04-12,1,8720,140,3487,2437,0,0,14784
2023-04-12,2,8726,139,3486,2377,0,0,14728
2023-04-12,3,8733,139,3438,2474,0,0,14784
2023-04-12,4,8732,139,3490,2373,0,0,14734
2023-04-12,5,8734,140,3502,2532,0,0,14908
2023-04-12,6,8733,139,3873,2726,0,4,15475
2023-04-12,7,8729,138,4288,3134,17,17,16323
2023-04-12,8,8728,138,4328,2968,85,21,16268
2023-04-12,9,8720,138,4411,2651,229,22,16171
2023-04-12,10,8721,142,4554,2493,370,26,16306
2023-04-12,11,8719,139,4463,2449,417,24,16211
2023-04-12,12,8723,216,4431,2684,425,27,16506
2023-04-12,13,8722,244,3801,3110,430,21,16328
2023-04-12,14,8724,245,3719,3263,426,18,16395
2023-04-12,15,8724,243,3687,3390,411,26,16481
2023-04-12,16,8723,289,4149,3395,348,24,16928
2023-04-12,17,8726,381,4675,3478,218,24,17502
2023-04-12,18,8722,370,4427,3456,68,16,17059
2023-04-12,19,8726,373,4705,3291,8,1,17104
2023-04-12,20,8719,367,4585,3564,0,0,17235
2023-04-12,21,8715,363,4565,3799,0,0,17442
2023-04-12,22,8721,364,4209,3749,0,0,17043
2023-04-12,23,8724,229,3728,3655,0,0,16336
2023-04-12,24,8720,143,3648,3238,0,0,15749
2023-04-13,1,8723,148,3596,2721,0,0,15188
2023-04-13,2,8726,144,3557,2539,0,0,14966
2023-04-13,3,8728,148,3560,2321,0,0,14757
2023-04-13,4,8718,148,3595,2419,0,0,14880
2023-04-13,5,8718,157,3656,2783,0,0,15314
2023-04-13,6,8720,248,3916,2954,0,8,15846
2023-04-13,7,8725,256,4241,3170,26,24,16442
2023-04-13,8,8722,260,4439,2669,122,27,16239
2023-04-13,9,8723,260,4794,1939,238,20,15974
2023-04-13,10,8666,318,4893,1628,325,17,15847
2023-04-13,11,8536,374,5144,1380,367,27,15828
2023-04-13,12,8534,590,5024,1520,375,22,16065
2023-04-13,13,8650,706,4386,1951,378,18,16089
2023-04-13,14,8714,1005,4294,1586,375,26,16000
2023-04-13,15,8713,1464,4403,1626,356,26,16588
2023-04-13,16,8718,1490,4319,2694,283,25,17529
2023-04-13,17,8718,1488,4499,2652,180,24,17561
2023-04-13,18,8708,1488,4869,2382,70,24,17541
2023-04-13,19,8706,1490,5000,2119,9,17,17341
2023-04-13,20,8704,1488,4854,2217,0,0,17263
2023-04-13,21,8706,1488,4708,2180,0,0,17082
2023-04-13,22,8702,1343,4286,2119,0,0,16450
2023-04-13,23,8708,543,4424,2052,0,0,15727
2023-04-13,24,8714,259,4741,1696,0,0,15410
2023-04-14,1,8720,143,4298,1365,0,0,14526
2023-04-14,2,8721,138,4565,1072,0,0,14496
2023-04-14,3,8725,139,4787,982,0,0,14633
2023-04-14,4,8720,373,4832,870,0,0,14795
2023-04-14,5,8720,792,4396,724,0,0,14632
2023-04-14,6,8717,1308,4823,619,1,2,15470
2023-04-14,7,8723,1415,5235,599,31,22,16025
2023-04-14,8,8716,1398,5191,470,121,23,15919
2023-04-14,9,8719,1391,5007,333,230,18,15698
2023-04-14,10,8723,1443,5372,271,310,17,16136
2023-04-14,11,8725,1477,5304,242,362,25,16135
2023-04-14,12,8723,1712,5358,197,374,24,16388
2023-04-14,13,8721,1379,5382,171,376,23,16052
2023-04-14,14,8722,1275,5430,171,369,23,15990
2023-04-14,15,8714,1471,5610,159,347,24,16325
2023-04-14,16,8710,1644,5642,121,269,21,16407
2023-04-14,17,8712,1867,5782,84,180,22,16647
2023-04-14,18,8712,2007,5868,84,72,20,16763
2023-04-14,19,8717,1824,5955,131,11,0,16638
2023-04-14,20,8717,1783,5897,290,0,0,16687
2023-04-14,21,8708,1741,5801,478,0,0,16728
2023-04-14,22,8718,1725,5269,696,0,0,16408
2023-04-14,23,8712,762,5095,884,0,0,15453
2023-04-14,24,8718,191,5050,783,0,0,14742
2023-04-15,1,8721,139,5029,649,0,0,14538
2023-04-15,2,8720,139,4999,570,0,0,14428
2023-04-15,3,8716,138,4817,622,0,0,14293
2023-04-15,4,8711,140,4747,633,0,0,14231
2023-04-15,5,8716,140,5165,633,0,0,14654
2023-04-15,6,8717,139,5174,614,0,0,14644
2023-04-15,7,8718,140,5002,559,24,0,14443
2023-04-15,8,8712,140,5059,409,101,0,14421
2023-04-15,9,8712,199,5454,265,231,0,14861
2023-04-15,10,8707,270,5732,157,269,0,15135
2023-04-15,11,8709,392,5716,103,282,0,15202
2023-04-15,12,8712,502,5460,93,364,0,15131
2023-04-15,13,8708,590,5026,119,347,0,14790
2023-04-15,14,8710,863,5310,211,340,0,15434
2023-04-15,15,8710,1255,5387,309,323,0,15984
2023-04-15,16,8708,1544,5579,326,252,0,16409
2023-04-15,17,8711,1614,5773,291,159,0,16548
2023-04-15,18,8712,1555,5736,242,73,0,16318
2023-04-15,19,8711,1534,5308,299,12,0,15864
2023-04-15,20,8709,1535,5237,472,0,0,15953
2023-04-15,21,8701,1421,4908,910,0,0,15940
2023-04-15,22,8706,1084,5121,758,0,0,15669
2023-04-15,23,8705,528,4862,699,0,0,14794
2023-04-15,24,8708,188,5148,559,0,0,14603
2023-04-16,1,8713,139,5005,568,0,0,14425
2023-04-16,2,8712,139,4575,975,0,0,14401
2023-04-16,3,8724,139,4202,1112,0,0,14177
2023-04-16,4,8716,139,4396,1115,0,0,14366
2023-04-16,5,8715,140,4364,1208,0,0,14427
2023-04-16,6,8716,221,4274,1299,0,0,14510
2023-04-16,7,8714,371,4581,1276,30,0,14972
2023-04-16,8,8709,488,4484,999,125,0,14805
2023-04-16,9,8715,489,4943,752,215,0,15114
2023-04-16,10,8714,490,5070,864,297,0,15435
2023-04-16,11,8710,486,4889,1257,349,0,15691
2023-04-16,12,8710,545,4590,1841,334,0,16020
2023-04-16,13,8711,623,4561,2008,330,0,16233
2023-04-16,14,8710,502,4641,2053,339,0,16245
2023-04-16,15,8707,371,5279,1869,291,0,16517
2023-04-16,16,8706,543,4598,2561,178,0,16586
2023-04-16,17,8708,766,4672,2653,93,0,16892
2023-04-16,18,8712,891,5022,2840,29,0,17494
2023-04-16,19,8714,894,4843,3290,6,0,17747
2023-04-16,20,8712,889,4729,3403,0,0,17733
2023-04-16,21,8711,726,4741,3531,0,0,17709
2023-04-16,22,8710,688,4305,2773,0,0,16476
2023-04-16,23,8706,595,4243,2334,0,0,15878
2023-04-16,24,8705,322,4159,1944,0,0,15130
2023-04-17,1,8702,142,4069,1826,0,0,14739
2023-04-17,2,8700,200,4008,1821,0,0,14729
2023-04-17,3,8707,294,3976,1170,0,0,14147
2023-04-17,4,8705,352,4093,1221,0,0,14371
2023-04-17,5,8706,352,4340,2087,0,0,15485
2023-04-17,6,8699,416,4492,1981,0,1,15589
2023-04-17,7,8698,561,4459,1962,8,14,15702
2023-04-17,8,8699,720,4541,2191,29,20,16200
2023-04-17,9,8699,794,4659,2385,55,17,16609
2023-04-17,10,8706,813,4904,2678,68,14,17183
2023-04-17,11,8702,894,4897,2807,91,14,17405
2023-04-17,12,8703,1078,4921,2998,118,20,17838
2023-04-17,13,8701,1157,4491,3019,195,21,17584
2023-04-17,14,8695,1345,4411,2361,179,18,17009
2023-04-17,15,8697,1457,4430,2297,112,20,17013
2023-04-17,16,8690,1371,4433,3108,111,19,17732
2023-04-17,17,8688,1481,4749,3006,51,18,17993
2023-04-17,18,8689,1596,4685,3154,22,11,18157
2023-04-17,19,8687,1722,4622,3151,7,0,18189
2023-04-17,20,8692,1725,4574,3365,0,0,18356
2023-04-17,21,8687,1339,4456,3211,0,0,17693
2023-04-17,22,8687,1107,4411,2830,0,0,17035
2023-04-17,23,8691,1106,4228,2449,0,0,16474
2023-04-17,24,8694,794,4221,2528,0,0,16237
2023-04-18,1,8696,402,4355,2659,0,0,16112
2023-04-18,2,8697,137,4212,2853,0,0,15899
2023-04-18,3,8697,255,4198,2734,0,0,15884
2023-04-18,4,8695,363,4330,2678,0,0,16066
2023-04-18,5,8695,498,4449,2678,0,2,16322
2023-04-18,6,8702,528,4350,2809,2,12,16403
2023-04-18,7,8696,577,4833,3285,28,21,17440
2023-04-18,8,8696,716,4989,3175,59,17,17652
2023-04-18,9,8692,746,4952,3350,119,17,17876
2023-04-18,10,8690,748,4951,3397,121,12,17919
2023-04-18,11,8691,772,4789,3569,132,13,17966
2023-04-18,12,8696,775,4723,3636,176,18,18024
2023-04-18,13,8694,754,4560,3588,92,17,17705
2023-04-18,14,8695,552,4548,3561,114,0,17470
2023-04-18,15,8697,442,4700,3375,117,7,17338
2023-04-18,16,8696,732,4776,3118,103,4,17429
2023-04-18,17,8690,966,5171,2876,55,1,17759
2023-04-18,18,8686,1149,5646,2612,16,0,18109
2023-04-18,19,8690,1421,5639,2546,4,0,18300
2023-04-18,20,8682,1247,5604,2280,0,0,17813
2023-04-18,21,8679,1135,5740,2088,0,0,17642
2023-04-18,22,8678,965,5587,1822,0,0,17052
2023-04-18,23,8686,593,4947,1950,0,0,16176
2023-04-18,24,8683,305,4444,2174,0,0,15606
2023-04-19,1,8690,200,4129,2440,0,0,15459
2023-04-19,2,8690,464,4148,2344,0,0,15646
2023-04-19,3,8693,615,4100,2311,0,0,15719
2023-04-19,4,8692,933,4100,2037,0,0,15762
2023-04-19,5,8685,1157,4299,2081,0,0,16222
2023-04-19,6,8686,1344,4623,1797,0,2,16452
2023-04-19,7,8686,1554,5511,1795,21,12,17579
2023-04-19,8,8684,1540,5529,1529,55,20,17357
2023-04-19,9,8681,1485,5443,1231,113,22,16975
2023-04-19,10,8685,1780,5608,704,161,18,16956
2023-04-19,11,8688,1853,5509,410,253,23,16736
2023-04-19,12,8689,1751,5445,410,278,28,16601
2023-04-19,13,8690,1713,5382,493,300,28,16606
2023-04-19,14,8696,1419,5067,606,346,29,16163
2023-04-19,15,8700,1527,4996,250,350,28,15851
2023-04-19,16,8699,1549,5176,408,266,26,16124
2023-04-19,17,8704,1694,5235,459,130,22,16244
2023-04-19,18,8709,1615,5401,420,61,15,16221
2023-04-19,19,8710,1554,5321,567,9,1,16162
2023-04-19,20,8707,1846,5602,654,0,0,16809
2023-04-19,21,8702,1829,5636,542,0,0,16709
2023-04-19,22,8706,1574,5482,446,0,0,16208
2023-04-19,23,8705,1525,4976,713,0,0,15919
2023-04-19,24,8709,1125,4573,1172,0,0,15579
2023-04-20,1,8707,381,4372,1540,0,0,15000
2023-04-20,2,8715,139,4397,1738,0,0,14989
2023-04-20,3,8718,332,4447,1869,0,0,15366
2023-04-20,4,8715,666,4378,1773,0,0,15532
2023-04-20,5,8715,1084,4368,2141,0,0,16308
2023-04-20,6,8718,1217,4536,2566,2,0,17039
2023-04-20,7,8716,1216,4678,3051,37,7,17705
2023-04-20,8,8713,1215,4534,2834,133,14,17443
2023-04-20,9,8715,1217,4481,2767,282,9,17471
2023-04-20,10,8711,1218,4730,1898,330,7,16894
2023-04-20,11,8709,778,4836,2305,385,13,17026
2023-04-20,12,8706,772,5086,2291,369,17,17241
2023-04-20,13,8704,609,4756,2007,371,20,16467
2023-04-20,14,8716,720,4613,1911,375,19,16354
2023-04-20,15,8713,858,4677,2081,333,22,16684
2023-04-20,16,8711,1269,5410,1657,258,21,17326
2023-04-20,17,8706,1615,5340,1964,134,17,17776
2023-04-20,18,8708,1522,4659,2118,53,12,17072
2023-04-20,19,8706,1271,4598,2493,9,2,17079
2023-04-20,20,8703,1238,4679,2845,0,0,17465
2023-04-20,21,8712,1236,4645,3131,0,0,17724
2023-04-20,22,8712,900,4806,3113,0,0,17531
2023-04-20,23,8708,406,4600,3181,0,0,16895
2023-04-20,24,8711,157,4454,3065,0,0,16387
2023-04-21,1,8705,157,4232,2860,0,0,15954
2023-04-21,2,8709,157,4297,2461,0,0,15624
2023-04-21,3,8716,158,4679,2168,0,0,15721
2023-04-21,4,8715,365,4733,1902,0,0,15715
2023-04-21,5,8716,494,4459,1987,0,0,15656
2023-04-21,6,8714,765,4599,1910,3,0,15991
2023-04-21,7,8716,696,4945,1841,29,7,16234
2023-04-21,8,8716,901,4784,1573,118,12,16104
2023-04-21,9,8710,969,5329,1068,212,10,16298
2023-04-21,10,8713,1224,5519,807,263,9,16535
2023-04-21,11,8707,1225,4807,1123,322,11,16195
2023-04-21,12,8711,1225,4603,1463,324,16,16342
2023-04-21,13,8712,1225,4714,1340,298,18,16307
2023-04-21,14,8713,936,5184,1072,284,19,16208
2023-04-21,15,8710,874,5504,948,255,17,16308
2023-04-21,16,8712,1193,5639,833,171,11,16559
2023-04-21,17,8713,1248,5383,822,130,11,16307
2023-04-21,18,8712,1229,5246,582,57,6,15832
2023-04-21,19,8708,1234,5389,482,9,0,15822
2023-04-21,20,8710,1308,5712,197,0,0,15927
2023-04-21,21,8711,1388,5542,435,0,0,16076
2023-04-21,22,8713,1227,5303,577,0,0,15820
2023-04-21,23,8716,997,5330,365,0,0,15408
2023-04-21,24,8715,921,5397,252,0,0,15285
2023-04-22,1,8721,386,5540,291,0,0,14938
2023-04-22,2,8720,185,5380,363,0,0,14648
2023-04-22,3,8716,266,5330,372,0,0,14684
2023-04-22,4,8718,373,5315,354,0,0,14760
2023-04-22,5,8712,514,5361,534,0,0,15121
2023-04-22,6,8708,504,5208,889,0,0,15309
2023-04-22,7,8710,505,4936,979,21,0,15151
2023-04-22,8,8711,513,5431,905,69,0,15629
2023-04-22,9,8707,784,5983,894,120,0,16488
2023-04-22,10,8709,871,5836,889,147,0,16452
2023-04-22,11,8711,976,5542,922,192,0,16343
2023-04-22,12,8708,956,5268,913,214,0,16059
2023-04-22,13,8711,962,4888,1190,171,0,15922
2023-04-22,14,8712,1003,4724,1491,127,0,16057
2023-04-22,15,8712,1145,5034,1555,112,0,16558
2023-04-22,16,8707,1187,5580,1250,81,0,16805
2023-04-22,17,8706,1164,5667,1218,84,0,16839
2023-04-22,18,8705,1138,5299,1194,51,0,16387
2023-04-22,19,8708,1139,5328,1184,8,0,16367
2023-04-22,20,8710,1142,5806,1061,0,0,16719
2023-04-22,21,8708,1156,5752,1110,0,0,16726
2023-04-22,22,8720,609,5138,1478,0,0,15945
2023-04-22,23,8712,507,5129,1363,0,0,15711
2023-04-22,24,8708,313,5154,1193,0,0,15368
2023-04-23,1,8709,151,4609,1335,0,0,14804
2023-04-23,2,8705,279,4321,1387,0,0,14692
2023-04-23,3,8705,380,4362,1394,0,0,14841
2023-04-23,4,8703,507,4491,1353,0,0,15054
2023-04-23,5,8705,506,4748,1211,0,0,15170
2023-04-23,6,8705,496,5259,1062,1,0,15523
2023-04-23,7,8704,502,5620,1033,26,0,15885
2023-04-23,8,8704,521,5982,829,80,0,16116
2023-04-23,9,8701,517,5831,833,160,0,16042
2023-04-23,10,8702,501,5313,844,223,0,15583
2023-04-23,11,8699,502,5775,997,215,0,16188
2023-04-23,12,8706,498,5857,1354,216,0,16631
2023-04-23,13,8707,555,5395,1434,184,0,16275
2023-04-23,14,8706,644,5561,1274,212,0,16397
2023-04-23,15,8705,1014,5835,1140,182,0,16876
2023-04-23,16,8703,1262,5900,975,93,0,16933
2023-04-23,17,8702,1557,5819,832,59,0,16969
2023-04-23,18,8709,1448,5585,858,34,0,16634
2023-04-23,19,8712,1405,5703,773,8,0,16601
2023-04-23,20,8712,1407,5632,622,0,0,16373
2023-04-23,21,8705,1441,6065,472,0,0,16683
2023-04-23,22,8714,1079,5848,468,0,0,16109
2023-04-23,23,8712,658,5775,446,0,0,15591
2023-04-23,24,8716,567,5460,338,0,0,15081
2023-04-24,1,8717,532,5168,289,0,0,14706
2023-04-24,2,8719,503,4919,404,0,0,14545
2023-04-24,3,8719,567,5030,398,0,0,14714
2023-04-24,4,8711,842,4702,460,0,0,14715
2023-04-24,5,8714,1327,5122,429,0,0,15592
2023-04-24,6,8714,1645,5713,359,0,0,16431
2023-04-24,7,8715,1885,6136,320,23,0,17079
2023-04-24,8,8715,1817,6122,292,70,0,17016
2023-04-24,9,8712,1681,5989,341,139,0,16862
2023-04-24,10,8711,1654,5853,375,164,0,16757
2023-04-24,11,8716,1795,6132,573,194,0,17410
2023-04-24,12,8711,1808,6113,693,258,0,17583
2023-04-24,13,8714,1716,6113,715,182,0,17440
2023-04-24,14,8715,1714,5809,760,153,0,17151
2023-04-24,15,8712,1871,5446,696,187,0,16912
2023-04-24,16,8703,1999,5633,572,151,0,17058
2023-04-24,17,8705,1884,6014,571,82,0,17256
2023-04-24,18,8714,1784,6155,357,67,0,17077
2023-04-24,19,8710,1795,6229,301,16,0,17051
2023-04-24,20,8706,1913,6316,263,0,0,17198
2023-04-24,21,8703,1783,6303,455,0,0,17244
2023-04-24,22,8702,1742,6011,621,0,0,17076
2023-04-24,23,8702,1073,5353,720,0,0,15848
2023-04-24,24,8707,558,5503,687,0,0,15455
2023-04-25,1,8708,496,5130,675,0,0,15009
2023-04-25,2,8705,495,5259,671,0,0,15130
2023-04-25,3,8706,612,5363,589,0,0,15270
2023-04-25,4,8711,980,5435,528,0,0,15654
2023-04-25,5,8612,1572,5337,440,0,0,15961
2023-04-25,6,8597,1866,5940,426,3,0,16832
2023-04-25,7,8596,2154,6173,424,47,0,17394
2023-04-25,8,8599,1902,6138,358,135,0,17132
2023-04-25,9,8706,1776,5668,578,164,0,16892
2023-04-25,10,8708,1758,5467,733,168,0,16834
2023-04-25,11,8710,1471,5856,921,188,0,17146
2023-04-25,12,8703,1414,5968,878,189,0,17152
2023-04-25,13,8704,1413,5860,775,269,0,17021
2023-04-25,14,8708,1607,5413,832,210,0,16770
2023-04-25,15,8712,1755,5264,831,183,0,16745
2023-04-25,16,8708,1757,5774,743,122,0,17104
2023-04-25,17,8703,1790,6117,611,118,0,17339
2023-04-25,18,8707,1895,6291,437,52,0,17382
2023-04-25,19,8641,1932,6314,358,12,0,17257
2023-04-25,20,7897,2915,6350,288,0,0,17450
2023-04-25,21,7891,2228,6229,230,0,0,16578
2023-04-25,22,7896,2101,6175,178,0,0,16350
2023-04-25,23,7901,1434,5956,127,0,0,15418
2023-04-25,24,7897,975,5746,94,0,0,14712
2023-04-26,1,7898,636,5733,81,0,0,14348
2023-04-26,2,7900,585,5366,88,0,0,13939
2023-04-26,3,7905,828,5257,55,0,0,14045
2023-04-26,4,7903,1232,5475,29,0,0,14639
2023-04-26,5,7910,1393,5402,26,0,0,14731
2023-04-26,6,7911,1604,5900,37,2,0,15454
2023-04-26,7,7909,2268,6149,49,28,0,16403
2023-04-26,8,7910,2258,6214,19,81,0,16482
2023-04-26,9,7911,2116,6119,4,145,0,16295
2023-04-26,10,7913,2019,6032,29,193,0,16186
2023-04-26,11,7913,1920,5979,123,212,0,16147
2023-04-26,12,7909,1900,5887,277,262,0,16235
2023-04-26,13,7902,1855,5768,374,267,0,16166
2023-04-26,14,7909,1933,5799,380,259,0,16280
2023-04-26,15,7914,1965,5629,385,234,0,16127
2023-04-26,16,7914,2004,5755,387,158,0,16218
2023-04-26,17,7910,2019,5731,367,111,0,16138
2023-04-26,18,7911,2019,6081,335,57,0,16403
2023-04-26,19,7911,2143,6216,258,13,0,16541
2023-04-26,20,7909,2531,6284,185,0,0,16909
2023-04-26,21,7908,2366,6186,189,0,0,16649
2023-04-26,22,7898,2192,5968,146,0,0,16204
2023-04-26,23,7891,1379,5861,159,0,0,15290
2023-04-26,24,7896,1182,5263,198,0,0,14539
2023-04-27,1,7899,879,5534,265,0,0,14577
2023-04-27,2,7902,988,5077,274,0,0,14241
2023-04-27,3,7903,1298,5251,282,0,0,14734
2023-04-27,4,7903,1599,5103,257,0,0,14862
2023-04-27,5,7904,2156,5186,285,0,0,15531
2023-04-27,6,7905,2247,5512,323,5,0,15992
2023-04-27,7,7909,2358,5977,365,54,0,16663
2023-04-27,8,7910,2297,5545,377,170,0,16299
2023-04-27,9,7904,2301,5376,397,300,0,16278
2023-04-27,10,7895,1852,5522,432,377,0,16078
2023-04-27,11,7898,1640,5823,532,382,0,16275
2023-04-27,12,7904,1656,5697,672,373,0,16302
2023-04-27,13,7902,1634,5609,730,392,0,16267
2023-04-27,14,7895,1805,5226,664,406,0,15996
2023-04-27,15,7896,1811,5057,667,392,0,15823
2023-04-27,16,7904,2303,4992,565,331,0,16095
2023-04-27,17,7900,1829,5780,703,222,0,16434
2023-04-27,18,7897,1667,6026,835,97,0,16522
2023-04-27,19,7901,1610,6100,937,21,0,16569
2023-04-27,20,7891,1570,5771,1041,0,0,16273
2023-04-27,21,7894,1622,5917,1275,0,0,16708
2023-04-27,22,7893,1265,5559,1767,0,0,16484
2023-04-27,23,7892,579,4815,2084,0,0,15370
2023-04-27,24,7894,517,4639,2194,0,0,15244
2023-04-28,1,7893,320,4605,2591,0,0,15409
2023-04-28,2,7902,236,4795,2665,0,0,15598
2023-04-28,3,7902,522,4735,2533,0,0,15692
2023-04-28,4,7902,779,4762,2454,0,0,15897
2023-04-28,5,7904,1022,4759,2468,0,0,16153
2023-04-28,6,7901,1225,4802,2496,6,0,16430
2023-04-28,7,7899,1352,5164,2339,47,0,16801
2023-04-28,8,7903,1348,5520,1960,125,0,16856
2023-04-28,9,7900,1347,5905,1665,196,0,17013
2023-04-28,10,7901,1544,6127,1525,218,0,17315
2023-04-28,11,7896,1452,5937,1543,243,0,17071
2023-04-28,12,7897,1153,5560,1708,220,0,16538
2023-04-28,13,7899,981,5550,2031,197,0,16658
2023-04-28,14,7902,1108,5250,2336,199,0,16795
2023-04-28,15,7903,883,5140,2669,180,0,16775
2023-04-28,16,7901,924,5415,2881,107,0,17228
2023-04-28,17,7898,925,5649,2956,53,0,17481
2023-04-28,18,7905,925,5732,3055,22,0,17639
2023-04-28,19,7903,932,5546,3257,5,0,17643
2023-04-28,20,7902,933,5432,3427,0,0,17694
2023-04-28,21,7892,591,5252,3526,0,0,17261
2023-04-28,22,7891,527,5009,3407,0,0,16834
2023-04-28,23,7894,424,4884,3238,0,0,16440
2023-04-28,24,7887,366,4530,3087,0,0,15870
2023-04-29,1,7891,220,4410,2801,0,0,15322
2023-04-29,2,7892,132,4657,2433,0,0,15114
2023-04-29,3,7894,133,4879,2278,0,0,15184
2023-04-29,4,7892,129,4791,2281,0,0,15093
2023-04-29,5,7890,127,4854,2122,0,0,14993
2023-04-29,6,7893,198,4638,2168,0,0,14897
2023-04-29,7,7892,336,4957,1791,8,0,14984
2023-04-29,8,7891,543,5687,1661,29,0,15811
2023-04-29,9,7893,566,6179,1459,55,0,16152
2023-04-29,10,7888,611,6156,1474,76,0,16205
2023-04-29,11,7884,899,5565,1522,95,0,15965
2023-04-29,12,7884,884,5825,1407,104,0,16104
2023-04-29,13,7883,893,5806,1324,99,0,16005
2023-04-29,14,7887,925,5859,1262,114,0,16047
2023-04-29,15,7895,928,5630,1218,140,0,15811
2023-04-29,16,7891,886,5573,1325,81,0,15756
2023-04-29,17,7892,887,5347,1364,61,0,15551
2023-04-29,18,7894,889,5724,1299,33,0,15839
2023-04-29,19,7894,889,5791,1173,9,0,15756
2023-04-29,20,7889,889,5959,1484,0,0,16221
2023-04-29,21,7885,888,5235,2032,0,0,16040
2023-04-29,22,7889,887,5073,1963,0,0,15812
2023-04-29,23,7885,537,4697,1936,0,0,15055
2023-04-29,24,7893,289,4821,2015,0,0,15018
2023-04-30,1,7891,132,5294,1739,0,0,15056
2023-04-30,2,7898,132,5362,1406,0,0,14798
2023-04-30,3,7896,260,5282,1165,0,0,14603
2023-04-30,4,7894,358,5261,995,0,0,14508
2023-04-30,5,7899,494,4493,857,0,0,13743
2023-04-30,6,7901,561,4677,805,3,0,13947
2023-04-30,7,7903,682,4803,694,22,0,14104
2023-04-30,8,7901,863,5274,792,29,0,14859
2023-04-30,9,7898,1083,5900,701,29,0,15611
2023-04-30,10,7891,1498,5853,773,70,0,16085
2023-04-30,11,7886,1487,5433,773,84,0,15663
2023-04-30,12,7885,1500,5203,663,70,0,15321
2023-04-30,13,7887,1499,5347,672,60,0,15465
2023-04-30,14,7888,1506,5337,771,81,0,15583
2023-04-30,15,7889,1530,5306,820,85,0,15630
2023-04-30,16,7883,1635,5564,850,76,0,16008
2023-04-30,17,7886,1681,5462,1140,46,0,16215
2023-04-30,18,7892,1696,5502,1204,34,0,16328
2023-04-30,19,7891,1714,5591,1065,13,0,16274
2023-04-30,20,7887,1693,5874,969,0,0,16423
2023-04-30,21,7887,1753,5897,816,0,0,16353
2023-04-30,22,7892,1673,5497,924,0,0,15986
2023-04-30,23,7901,1375,5090,959,0,0,15325
2023-04-30,24,7939,805,5036,884,0,0,14664
2023-05-01,1,8079,307,5236,963,0,0,14585
2023-05-01,2,8120,124,5286,1097,0,0,14627
2023-05-01,3,8080,259,4952,1300,0,0,14591
2023-05-01,4,8195,350,4704,1305,0,0,14554
2023-05-01,5,8304,585,4600,1260,0,0,14749
2023-05-01,6,8308,876,4798,1516,1,0,15499
2023-05-01,7,8359,890,5411,1552,23,0,16235
2023-05-01,8,8478,888,5608,1656,46,0,16676
2023-05-01,9,8475,906,5216,1887,75,0,16559
2023-05-01,10,8474,1017,5576,2149,127,0,17343
2023-05-01,11,8476,1170,5238,2429,214,0,17527
2023-05-01,12,8478,1230,5403,2319,254,0,17684
2023-05-01,13,8478,934,5357,2126,246,0,17141
2023-05-01,14,8482,1197,5436,2242,258,0,17615
2023-05-01,15,8481,1143,5209,2755,252,0,17840
2023-05-01,16,8481,1262,5392,2504,244,0,17883
2023-05-01,17,8504,1301,5415,2465,153,0,17838
2023-05-01,18,8599,1298,5509,2606,58,0,18070
2023-05-01,19,8612,1288,5446,2736,16,0,18098
2023-05-01,20,8612,1284,5443,2993,0,0,18332
2023-05-01,21,8615,1283,5254,3087,0,0,18239
2023-05-01,22,8607,1004,5291,2545,0,0,17447
2023-05-01,23,8611,447,5133,2296,0,0,16487
2023-05-01,24,8607,207,5147,1770,0,0,15731
2023-05-02,1,8609,125,4921,1705,0,0,15360
2023-05-02,2,8626,243,4441,1711,0,0,15021
2023-05-02,3,8649,467,4328,1560,0,0,15004
2023-05-02,4,8646,743,4328,1373,0,0,15090
2023-05-02,5,8595,1134,4637,1317,0,0,15683
2023-05-02,6,8588,1529,4900,1704,6,0,16727
2023-05-02,7,8586,1546,5487,1760,54,0,17433
2023-05-02,8,8581,1551,5661,1871,101,0,17765
2023-05-02,9,8583,1552,5240,1772,138,0,17285
2023-05-02,10,8581,1475,5254,1764,163,0,17237
2023-05-02,11,8578,1441,5258,1810,198,0,17285
2023-05-02,12,8580,1355,5361,1785,222,0,17303
2023-05-02,13,8579,1311,5211,1812,223,0,17136
2023-05-02,14,8583,1649,5110,1576,234,0,17152
2023-05-02,15,8602,1786,4950,1769,205,0,17312
2023-05-02,16,8642,1941,5344,1712,153,0,17792
2023-05-02,17,8659,1862,5910,1339,102,0,17872
2023-05-02,18,8663,1998,6007,1260,52,0,17980
2023-05-02,19,8663,1800,5653,1341,11,0,17468
2023-05-02,20,8664,1777,5913,1229,0,0,17583
2023-05-02,21,8667,1783,5844,1065,0,0,17359
2023-05-02,22,8663,1770,5482,1061,0,0,16976
2023-05-02,23,8676,1053,5373,1130,0,0,16232
2023-05-02,24,8676,557,4979,1241,0,0,15453
2023-05-03,1,8676,278,4887,1191,0,0,15032
2023-05-03,2,8675,125,5419,1100,0,0,15319
2023-05-03,3,8678,247,5204,1165,0,0,15294
2023-05-03,4,8675,366,5366,938,0,0,15345
2023-05-03,5,8625,475,5205,874,0,0,15179
2023-05-03,6,8620,603,5641,848,2,26,15740
2023-05-03,7,8625,945,5672,1262,17,44,16565
2023-05-03,8,8619,928,5504,1807,59,45,16962
2023-05-03,9,8598,925,5338,2233,109,43,17246
2023-05-03,10,8561,925,5260,2566,153,43,17508
2023-05-03,11,8562,1000,5067,2609,181,44,17463
2023-05-03,12,8556,800,5118,2073,202,42,16791
2023-05-03,13,8643,801,4943,2523,210,42,17162
2023-05-03,14,8680,712,4923,2711,164,43,17233
2023-05-03,15,8676,774,5159,2756,136,41,17542
2023-05-03,16,8664,928,5274,2829,117,40,17852
2023-05-03,17,8669,944,5359,2740,84,39,17835
2023-05-03,18,8675,1006,5498,2506,43,39,17767
2023-05-03,19,8677,1139,5800,2287,12,15,17930
2023-05-03,20,8674,1144,5785,2043,0,0,17646
2023-05-03,21,8676,1182,5841,1829,0,0,17528
2023-05-03,22,8678,1154,5758,1603,0,0,17193
2023-05-03,23,8674,784,5481,1397,0,0,16336
2023-05-03,24,8676,489,5085,1241,0,0,15491
2023-05-04,1,8684,154,5094,1063,0,0,14995
2023-05-04,2,8683,245,5165,796,0,18,14907
2023-05-04,3,8683,454,5018,813,0,38,15006
2023-05-04,4,8674,793,4779,783,0,41,15070
2023-05-04,5,8624,1057,4865,683,0,43,15272
2023-05-04,6,8624,1239,5304,554,2,44,15767
2023-05-04,7,8629,1969,5764,418,30,45,16855
2023-05-04,8,8630,2300,5849,256,71,45,17151
2023-05-04,9,8633,2334,5811,156,110,43,17087
2023-05-04,10,8626,2225,5682,128,146,41,16848
2023-05-04,11,8628,2035,5646,177,175,43,16704
2023-05-04,12,8630,1975,5595,270,194,45,16709
2023-05-04,13,8627,2004,5568,367,178,43,16787
2023-05-04,14,8656,1846,5402,421,204,38,16567
2023-05-04,15,8693,1924,5260,409,183,30,16499
2023-05-04,16,8697,1968,5371,420,162,30,16648
2023-05-04,17,8696,2043,5756,381,81,28,16985
2023-05-04,18,8694,2165,5881,252,41,22,17055
2023-05-04,19,8694,2218,5904,175,12,23,17026
2023-05-04,20,8686,2259,5988,143,0,20,17096
2023-05-04,21,8692,2350,5893,157,0,4,17096
2023-05-04,22,8696,2037,5654,200,0,0,16587
2023-05-04,23,8693,1809,4965,167,0,0,15634
2023-05-04,24,8699,1408,4865,168,0,0,15140
2023-05-05,1,8692,498,5231,257,0,0,14678
2023-05-05,2,8701,402,4990,288,0,0,14381
2023-05-05,3,8706,490,5038,260,0,0,14494
2023-05-05,4,8708,495,5149,264,0,0,14616
2023-05-05,5,8708,591,5063,289,0,0,14651
2023-05-05,6,8706,872,5002,329,4,1,14914
2023-05-05,7,8705,1001,5645,305,46,19,15721
2023-05-05,8,8701,1252,5724,148,126,22,15973
2023-05-05,9,8700,1581,5601,102,229,19,16232
2023-05-05,10,8704,1730,5574,123,285,18,16434
2023-05-05,11,8704,1591,5513,123,316,27,16274
2023-05-05,12,8702,1587,5413,120,334,28,16184
2023-05-05,13,8704,1911,5014,244,292,27,16192
2023-05-05,14,8700,1815,5030,299,279,21,16144
2023-05-05,15,8700,1757,5141,316,221,18,16153
2023-05-05,16,8700,1759,5207,351,225,20,16262
2023-05-05,17,8700,1795,5416,513,188,5,16617
2023-05-05,18,8699,1923,5216,648,90,0,16576
2023-05-05,19,8701,1923,5365,690,20,0,16699
2023-05-05,20,8692,1922,5253,823,0,0,16690
2023-05-05,21,8694,1923,5188,1361,0,0,17166
2023-05-05,22,8690,1584,4805,1353,0,0,16432
2023-05-05,23,8693,672,4774,1505,0,0,15644
2023-05-05,24,8696,481,4602,1634,0,0,15413
2023-05-06,1,8701,270,4473,1616,0,0,15060
2023-05-06,2,8702,127,4528,1593,0,0,14950
2023-05-06,3,8704,194,4219,1721,0,0,14838
2023-05-06,4,8709,284,4277,1499,0,0,14769
2023-05-06,5,8708,348,4762,1222,0,0,15040
2023-05-06,6,8711,349,5085,1156,6,0,15307
2023-05-06,7,8710,378,5001,1155,56,0,15300
2023-05-06,8,8707,382,5164,831,175,0,15259
2023-05-06,9,8699,383,5404,658,298,0,15442
2023-05-06,10,8700,383,5402,579,354,0,15418
2023-05-06,11,8703,455,5200,525,362,0,15245
2023-05-06,12,8700,473,5217,476,373,0,15239
2023-05-06,13,8698,720,4900,483,369,0,15170
2023-05-06,14,8692,997,4785,404,362,0,15240
2023-05-06,15,8698,1117,4777,346,310,0,15248
2023-05-06,16,8703,1426,4912,491,263,0,15795
2023-05-06,17,8703,1589,5215,738,177,0,16422
2023-05-06,18,8708,1590,5321,857,85,0,16561
2023-05-06,19,8711,1592,5518,862,21,0,16704
2023-05-06,20,8709,1590,5493,991,0,0,16783
2023-05-06,21,8712,1427,5301,1360,0,0,16800
2023-05-06,22,8710,1064,5032,1462,0,0,16268
2023-05-06,23,8711,534,4831,1546,0,0,15622
2023-05-06,24,8712,378,4717,1051,0,0,14858
2023-05-07,1,8714,245,4630,1150,0,0,14739
2023-05-07,2,8713,155,4028,1425,0,0,14321
2023-05-07,3,8717,156,3719,1575,0,0,14167
2023-05-07,4,8713,156,3822,1402,0,0,14093
2023-05-07,5,8705,220,3712,1344,0,0,13981
2023-05-07,6,8710,315,3847,1105,5,0,13982
2023-05-07,7,8707,377,4214,951,40,0,14289
2023-05-07,8,8703,379,4467,1014,109,0,14672
2023-05-07,9,8698,378,4578,853,171,0,14678
2023-05-07,10,8692,380,5092,977,253,0,15394
2023-05-07,11,8695,460,5260,1347,242,0,16004
2023-05-07,12,8696,471,5225,933,236,0,15561
2023-05-07,13,8696,630,4946,1107,215,0,15594
2023-05-07,14,8692,858,5151,1117,141,0,15959
2023-05-07,15,8636,1188,5664,724,147,0,16359
2023-05-07,16,8695,1181,5846,484,175,0,16381
2023-05-07,17,8699,1181,6016,414,106,0,16416
2023-05-07,18,8699,1187,5984,508,49,0,16427
2023-05-07,19,8701,1188,5766,806,9,0,16470
2023-05-07,20,8693,1190,5516,919,0,0,16318
2023-05-07,21,8699,1188,5403,1145,0,0,16435
2023-05-07,22,8700,1185,5030,1403,0,0,16318
2023-05-07,23,8699,513,4745,1136,0,0,15093
2023-05-07,24,8256,318,5086,1389,0,0,15049
2023-05-08,1,7875,256,5741,1319,0,0,15191
2023-05-08,2,7869,283,5409,1202,0,0,14763
2023-05-08,3,7872,388,5389,1012,0,0,14661
2023-05-08,4,7878,614,4998,991,0,0,14481
2023-05-08,5,7882,850,5160,927,0,0,14819
2023-05-08,6,7886,1278,5174,1012,10,0,15360
2023-05-08,7,7890,1357,5983,687,55,0,15972
2023-05-08,8,7885,1632,6075,392,162,0,16146
2023-05-08,9,7882,1689,5964,335,278,0,16148
2023-05-08,10,7883,1559,5475,329,362,0,15608
2023-05-08,11,7886,1585,5486,346,405,0,15708
2023-05-08,12,7884,1603,5368,413,401,0,15669
2023-05-08,13,7877,1746,5480,380,394,0,15877
2023-05-08,14,7879,1810,5428,416,392,0,15925
2023-05-08,15,7875,1911,5287,509,368,0,15950
2023-05-08,16,7875,2064,5528,609,294,0,16370
2023-05-08,17,7875,2231,6069,617,178,0,16970
2023-05-08,18,7875,2167,5951,636,87,0,16716
2023-05-08,19,7880,2114,5939,784,26,0,16743
2023-05-08,20,7876,2109,5755,1052,1,0,16793
2023-05-08,21,7878,2173,5873,1213,0,0,17137
2023-05-08,22,7874,1616,5335,1266,0,0,16091
2023-05-08,23,7878,830,5378,1487,0,0,15573
2023-05-08,24,7882,510,4894,1744,0,0,15030
2023-05-09,1,7885,206,5388,1641,0,0,15120
2023-05-09,2,7889,279,4952,1582,0,0,14702
2023-05-09,3,7892,391,4764,1403,0,0,14450
2023-05-09,4,7892,657,4964,1369,0,0,14882
2023-05-09,5,7897,915,4955,1284,0,0,15051
2023-05-09,6,7900,1322,5119,1321,10,0,15672
2023-05-09,7,7900,1422,5929,920,59,0,16230
2023-05-09,8,7900,1807,6023,452,165,0,16347
2023-05-09,9,7896,1646,5725,281,288,0,15836
2023-05-09,10,7895,1605,5590,240,375,0,15705
2023-05-09,11,7890,1683,5423,353,420,0,15769
2023-05-09,12,7890,1481,5148,528,424,0,15471
2023-05-09,13,7892,1278,5120,756,421,0,15467
2023-05-09,14,7893,1464,4828,900,414,0,15499
2023-05-09,15,7883,1427,4760,973,390,0,15433
2023-05-09,16,7879,1665,5324,963,309,0,16140
2023-05-09,17,7880,1829,5825,856,207,0,16597
2023-05-09,18,7880,1974,6162,691,95,0,16802
2023-05-09,19,7883,1938,6192,469,26,0,16508
2023-05-09,20,7877,2087,6321,304,1,0,16590
2023-05-09,21,7878,2263,6090,219,0,0,16450
2023-05-09,22,7874,1930,6076,173,0,0,16053
2023-05-09,23,7879,1532,5649,206,0,0,15266
2023-05-09,24,7982,880,5412,208,0,0,14482
2023-05-10,1,8125,485,5414,195,0,0,14219
2023-05-10,2,8129,382,5550,173,0,0,14234
2023-05-10,3,8122,454,5410,135,0,0,14121
2023-05-10,4,8104,634,5500,119,0,0,14357
2023-05-10,5,8105,803,5319,133,0,0,14360
2023-05-10,6,8104,1141,5514,143,17,0,14919
2023-05-10,7,8106,1143,6071,105,70,0,15495
2023-05-10,8,8112,1170,5935,50,158,0,15425
2023-05-10,9,8128,1216,5895,24,270,0,15533
2023-05-10,10,8302,1221,5805,42,347,0,15717
2023-05-10,11,8342,1276,5632,140,402,0,15792
2023-05-10,12,8357,842,5859,225,419,0,15702
2023-05-10,13,8511,807,5462,359,420,0,15559
2023-05-10,14,8522,1163,5030,549,398,0,15662
2023-05-10,15,8496,1333,4907,633,336,0,15705
2023-05-10,16,8476,1401,5205,709,299,0,16090
2023-05-10,17,8469,1644,5477,771,208,0,16569
2023-05-10,18,8466,1716,5418,841,103,0,16544
2023-05-10,19,8464,1718,5554,906,29,0,16671
2023-05-10,20,8460,1638,5668,986,2,0,16754
2023-05-10,21,8456,1462,5620,1114,0,0,16652
2023-05-10,22,8526,987,5344,1235,0,0,16092
2023-05-10,23,8636,573,5172,761,0,0,15142
2023-05-10,24,8639,310,5036,881,0,0,14866
2023-05-11,1,8635,155,4724,1348,0,0,14862
2023-05-11,2,8642,273,4444,1259,0,0,14618
2023-05-11,3,8634,383,4430,1221,0,0,14668
2023-05-11,4,8644,625,4505,874,0,0,14648
2023-05-11,5,8642,842,4657,943,0,0,15084
2023-05-11,6,8637,1137,5072,782,11,0,15639
2023-05-11,7,8658,1192,5966,752,66,0,16634
2023-05-11,8,8669,1245,6065,449,156,0,16584
2023-05-11,9,8668,1241,5993,274,286,0,16462
2023-05-11,10,8662,1305,5681,232,350,0,16230
2023-05-11,11,8662,1405,5483,274,366,0,16190
2023-05-11,12,8663,1603,5174,465,413,0,16318
2023-05-11,13,8665,1670,5061,658,400,0,16454
2023-05-11,14,8659,1688,4861,735,385,0,16328
2023-05-11,15,8650,1896,4857,885,372,0,16660
2023-05-11,16,8652,1814,5358,968,331,0,17123
2023-05-11,17,8657,1934,5605,1040,268,0,17504
2023-05-11,18,8665,1972,5775,885,175,0,17472
2023-05-11,19,8669,1964,6237,791,118,0,17779
2023-05-11,20,8666,1969,6122,873,99,0,17729
2023-05-11,21,8661,2031,6127,996,98,0,17913
2023-05-11,22,8663,1622,5505,1217,98,0,17105
2023-05-11,23,8669,903,5215,1317,98,0,16202
2023-05-11,24,8666,544,5134,1360,98,0,15802
2023-05-12,1,8669,276,4817,1350,98,0,15210
2023-05-12,2,8664,126,4748,1342,7,0,14887
2023-05-12,3,8664,247,4842,963,1,0,14717
2023-05-12,4,8663,478,4797,683,0,0,14621
2023-05-12,5,8659,913,5095,592,0,0,15259
2023-05-12,6,8656,1452,5014,402,9,0,15533
2023-05-12,7,8652,1723,5811,370,56,0,16612
2023-05-12,8,8648,1938,5733,194,148,0,16661
2023-05-12,9,8644,1933,5672,49,267,0,16565
2023-05-12,10,8644,1951,5769,44,351,0,16759
2023-05-12,11,8647,2006,5795,70,343,0,16861
2023-05-12,12,8641,2026,5806,152,367,0,16992
2023-05-12,13,8647,2184,5794,217,372,0,17214
2023-05-12,14,8647,2324,5830,323,359,0,17483
2023-05-12,15,8647,2445,5902,374,345,0,17713
2023-05-12,16,8647,2758,6004,427,252,0,18088
2023-05-12,17,8648,3068,6109,392,167,0,18384
2023-05-12,18,8651,2825,6186,376,82,0,18120
2023-05-12,19,8650,2690,6166,429,26,0,17961
2023-05-12,20,8646,2571,6339,434,0,0,17990
2023-05-12,21,8682,2628,6212,401,0,0,17923
2023-05-12,22,8739,2397,5672,475,0,0,17283
2023-05-12,23,8756,1662,5354,685,0,0,16457
2023-05-12,24,8751,817,5386,754,0,0,15708
2023-05-13,1,8754,444,5436,838,0,0,15472
2023-05-13,2,8762,359,5561,902,0,0,15584
2023-05-13,3,8771,359,5047,931,0,0,15108
2023-05-13,4,8768,358,5100,926,0,0,15152
2023-05-13,5,8771,356,4820,1030,0,0,14977
2023-05-13,6,8764,356,4747,957,9,0,14833
2023-05-13,7,8773,358,4941,947,63,0,15082
2023-05-13,8,8778,372,6024,683,156,0,16013
2023-05-13,9,8786,457,6144,560,246,0,16193
2023-05-13,10,8776,423,6108,511,314,0,16132
2023-05-13,11,8777,390,5398,615,386,0,15566
2023-05-13,12,8777,359,5535,632,378,0,15681
2023-05-13,13,8769,366,5406,762,398,0,15701
2023-05-13,14,8775,515,5296,1042,401,0,16029
2023-05-13,15,8775,664,5159,1285,392,0,16275
2023-05-13,16,8787,978,5674,1415,283,0,17137
2023-05-13,17,8790,978,5635,1450,196,0,17049
2023-05-13,18,8866,976,5817,1422,107,0,17188
2023-05-13,19,8907,976,5736,1378,27,0,17024
2023-05-13,20,8949,973,5564,1512,3,0,17001
2023-05-13,21,8959,972,5596,1923,0,0,17450
2023-05-13,22,8969,485,5241,2145,0,0,16840
2023-05-13,23,8968,362,5090,1455,0,0,15875
2023-05-13,24,8967,219,4607,1514,0,0,15307
2023-05-14,1,8978,126,4319,1517,0,0,14940
2023-05-14,2,9005,125,3905,1555,0,0,14590
2023-05-14,3,9139,125,3838,1180,0,0,14282
2023-05-14,4,9169,125,3966,1128,0,0,14388
2023-05-14,5,9170,126,3984,905,0,0,14185
2023-05-14,6,9175,125,4061,816,12,0,14189
2023-05-14,7,9176,125,4116,1026,66,0,14509
2023-05-14,8,9168,125,4341,925,185,0,14744
2023-05-14,9,9171,125,4394,777,292,0,14759
2023-05-14,10,9169,144,4367,791,394,0,14865
2023-05-14,11,9169,191,4303,843,408,0,14914
2023-05-14,12,9158,280,4229,826,411,0,14904
2023-05-14,13,9153,353,3807,889,408,0,14610
2023-05-14,14,9169,355,3843,591,391,0,14349
2023-05-14,15,9172,354,3846,917,358,0,14647
2023-05-14,16,9169,354,4177,957,286,0,14943
2023-05-14,17,9185,355,4617,1302,191,0,15650
2023-05-14,18,9199,353,5115,1228,95,0,15990
2023-05-14,19,9201,354,5565,1046,27,0,16193
2023-05-14,20,9202,355,5782,921,1,0,16261
2023-05-14,21,9198,354,5780,939,0,0,16271
2023-05-14,22,9202,355,5678,921,0,0,16156
2023-05-14,23,9214,355,5134,845,0,0,15548
2023-05-14,24,9237,287,4402,977,0,0,14903
2023-05-15,1,9234,144,4178,638,0,0,14194
2023-05-15,2,9243,436,4179,440,0,0,14298
2023-05-15,3,9242,467,4154,377,0,0,14240
2023-05-15,4,9240,516,4239,399,0,0,14394
2023-05-15,5,9243,570,4570,313,0,0,14696
2023-05-15,6,9241,618,4851,359,15,0,15084
2023-05-15,7,9244,643,5337,430,66,4,15724
2023-05-15,8,9240,670,5546,232,167,6,15861
2023-05-15,9,9235,673,5468,297,293,3,15969
2023-05-15,10,9235,577,5341,468,387,2,16010
2023-05-15,11,9235,681,5221,548,419,8,16112
2023-05-15,12,9242,758,5207,824,413,5,16449
2023-05-15,13,9236,890,4713,1091,413,8,16351
2023-05-15,14,9243,981,4593,1167,394,26,16404
2023-05-15,15,9234,1102,4689,1052,372,11,16460
2023-05-15,16,9229,1102,4970,1101,321,8,16731
2023-05-15,17,9225,1099,5169,1497,210,16,17216
2023-05-15,18,9219,1098,5295,1571,99,21,17303
2023-05-15,19,9217,1098,5639,1541,26,12,17533
2023-05-15,20,9219,1099,5733,1721,1,11,17784
2023-05-15,21,9217,1096,5398,2016,0,11,17738
2023-05-15,22,9214,598,4996,2179,0,11,16998
2023-05-15,23,9218,282,4461,1689,0,11,15661
2023-05-15,24,9226,128,3946,1588,0,11,14899
2023-05-16,1,9224,128,3899,1371,0,8,14630
2023-05-16,2,9226,128,3696,1223,0,12,14285
2023-05-16,3,9222,128,3704,918,0,9,13981
2023-05-16,4,9228,128,3836,920,0,11,14123
2023-05-16,5,9222,128,4053,1300,0,10,14713
2023-05-16,6,9225,129,4364,1887,10,10,15625
2023-05-16,7,9222,182,4521,2296,46,11,16278
2023-05-16,8,9220,129,5049,1846,116,11,16371
2023-05-16,9,9212,129,5349,1751,205,4,16650
2023-05-16,10,9212,129,5155,1900,271,0,16667
2023-05-16,11,9220,129,4587,2301,327,0,16564
2023-05-16,12,9214,232,4349,2490,351,1,16637
2023-05-16,13,9211,355,4181,2997,291,0,17035
2023-05-16,14,9218,456,4179,2987,262,10,17112
2023-05-16,15,9216,465,4355,3084,178,18,17316
2023-05-16,16,9212,475,4580,2679,156,17,17119
2023-05-16,17,9217,475,4789,2379,143,21,17024
2023-05-16,18,9219,475,5039,2298,72,18,17121
2023-05-16,19,9223,476,5244,2569,18,2,17532
2023-05-16,20,9222,476,5227,2569,0,0,17494
2023-05-16,21,9219,477,5538,2555,0,0,17789
2023-05-16,22,9224,476,4887,2482,0,0,17069
2023-05-16,23,9226,289,3950,2343,0,0,15808
2023-05-16,24,9228,128,3776,1985,0,0,15117
2023-05-17,1,9236,255,3696,1554,0,0,14741
2023-05-17,2,9240,340,3706,1409,0,0,14695
2023-05-17,3,9233,467,3692,1141,0,0,14533
2023-05-17,4,9233,472,3725,1175,0,0,14605
2023-05-17,5,9235,473,3910,1441,0,0,15059
2023-05-17,6,9236,471,4561,1696,13,3,15980
2023-05-17,7,9237,470,5268,1764,58,7,16804
2023-05-17,8,9143,521,5082,1605,160,9,16520
2023-05-17,9,8588,657,4856,1193,277,9,15580
2023-05-17,10,8954,313,4579,795,356,13,15010
2023-05-17,11,9205,231,4748,969,360,15,15528
2023-05-17,12,9209,410,4958,1000,352,20,15949
2023-05-17,13,9214,563,4541,1104,366,20,15808
2023-05-17,14,9215,767,4485,1094,367,24,15952
2023-05-17,15,9239,978,4248,918,346,25,15754
2023-05-17,16,9237,1270,4611,649,291,28,16086
2023-05-17,17,9235,1282,4973,822,202,27,16541
2023-05-17,18,9235,1277,5556,827,104,25,17024
2023-05-17,19,9237,1276,6039,627,30,4,17213
2023-05-17,20,9232,1277,6092,543,4,0,17148
2023-05-17,21,9226,1358,6181,507,0,0,17272
2023-05-17,22,9227,890,5871,404,0,0,16392
2023-05-17,23,9218,365,5499,405,0,0,15487
2023-05-17,24,9230,344,5061,546,0,0,15181
2023-05-18,1,9234,318,4781,599,0,0,14932
2023-05-18,2,9233,296,4936,562,0,0,15027
2023-05-18,3,9236,377,4994,481,0,0,15088
2023-05-18,4,9231,534,5068,431,0,0,15264
2023-05-18,5,9234,794,4995,473,0,0,15496
2023-05-18,6,9138,890,5068,453,17,1,15567
2023-05-18,7,9119,1014,5851,381,72,24,16461
2023-05-18,8,9117,1037,6086,189,179,27,16635
2023-05-18,9,9113,970,5869,243,294,19,16508
2023-05-18,10,9117,977,5791,255,377,20,16537
2023-05-18,11,9113,861,5488,295,404,20,16181
2023-05-18,12,9214,857,5394,420,417,19,16321
2023-05-18,13,9225,1187,5278,471,414,23,16598
2023-05-18,14,9217,1212,4779,585,413,34,16240
2023-05-18,15,9230,883,5014,535,398,30,16090
2023-05-18,16,9239,940,5352,471,319,27,16348
2023-05-18,17,9227,1160,5691,453,216,28,16775
2023-05-18,18,9226,1525,5741,475,103,25,17095
2023-05-18,19,9232,1664,5944,496,28,1,17365
2023-05-18,20,9229,1436,5867,595,2,0,17129
2023-05-18,21,9230,1373,5672,880,0,0,17155
2023-05-18,22,9221,1137,5209,1065,0,0,16632
2023-05-18,23,9224,728,4698,1244,0,0,15894
2023-05-18,24,9226,228,4210,1671,0,0,15335
2023-05-19,1,9223,127,4048,1657,0,0,15055
2023-05-19,2,9224,127,3701,1578,0,0,14630
2023-05-19,3,9228,127,3696,1450,0,0,14501
2023-05-19,4,9231,127,3679,1377,0,0,14414
2023-05-19,5,9227,127,3780,1577,0,0,14711
2023-05-19,6,9228,126,4197,2048,14,0,15613
2023-05-19,7,9226,126,4465,2364,63,7,16251
2023-05-19,8,9224,125,4821,2239,138,11,16558
2023-05-19,9,9221,125,4681,2161,226,3,16417
2023-05-19,10,9228,125,4600,2101,280,1,16335
2023-05-19,11,9226,125,4578,2471,302,2,16704
2023-05-19,12,9229,238,4363,2560,339,0,16729
2023-05-19,13,9231,403,4306,2547,269,4,16760
2023-05-19,14,9228,589,4571,2065,254,6,16713
2023-05-19,15,9230,597,4938,1840,219,3,16827
2023-05-19,16,9228,569,5213,2080,124,18,17232
2023-05-19,17,9232,543,5408,2005,65,59,17312
2023-05-19,18,9230,477,5729,1653,35,57,17181
2023-05-19,19,9228,610,5831,1220,15,52,16956
2023-05-19,20,9225,505,6271,982,0,52,17035
2023-05-19,21,9223,511,6139,926,0,62,16861
2023-05-19,22,9228,411,5600,1053,0,54,16346
2023-05-19,23,9225,250,5080,1246,0,54,15855
2023-05-19,24,9226,158,4456,1242,0,54,15136
2023-05-20,1,9227,158,4483,831,0,54,14753
2023-05-20,2,9226,158,4209,1010,0,54,14657
2023-05-20,3,9226,158,3962,1102,0,52,14500
2023-05-20,4,9228,211,3726,1064,0,52,14281
2023-05-20,5,9237,289,3762,943,0,17,14248
2023-05-20,6,9208,400,4063,718,3,0,14392
2023-05-20,7,8713,381,4614,971,20,0,14699
2023-05-20,8,8712,300,5203,937,55,0,15207
2023-05-20,9,8710,304,5697,1175,84,10,15980
2023-05-20,10,8702,464,5895,1076,91,42,16270
2023-05-20,11,8704,413,5765,1167,100,60,16209
2023-05-20,12,8703,289,5533,1358,161,59,16103
2023-05-20,13,8702,159,4918,1694,180,52,15705
2023-05-20,14,8702,248,4561,1686,204,52,15453
2023-05-20,15,8705,304,4803,1879,185,51,15927
2023-05-20,16,8700,343,5034,1874,98,51,16100
2023-05-20,17,8699,343,5510,1906,70,52,16580
2023-05-20,18,8694,345,5768,1503,65,50,16425
2023-05-20,19,8693,342,5704,1278,15,51,16083
2023-05-20,20,8692,344,5665,1161,1,52,15915
2023-05-20,21,8691,344,5402,1261,0,52,15750
2023-05-20,22,8695,344,5193,1389,0,30,15651
2023-05-20,23,8696,247,4325,1799,0,50,15117
2023-05-20,24,8699,179,4205,1261,0,55,14399
2023-05-21,1,8702,148,3789,1431,0,14,14084
2023-05-21,2,8706,133,3796,970,0,0,13605
2023-05-21,3,8708,126,3624,867,0,0,13325
2023-05-21,4,8713,126,3767,1165,0,0,13771
2023-05-21,5,8717,126,3813,1045,0,0,13701
2023-05-21,6,8722,126,3788,1179,9,0,13824
2023-05-21,7,8724,126,3933,1362,69,33,14247
2023-05-21,8,8723,126,4359,1118,179,54,14559
2023-05-21,9,8718,127,4357,811,276,51,14340
2023-05-21,10,8718,126,4510,821,360,51,14586
2023-05-21,11,8722,209,4622,659,405,51,14668
2023-05-21,12,8723,290,4729,493,417,51,14703
2023-05-21,13,8720,337,4534,520,415,50,14576
2023-05-21,14,8718,338,4712,408,402,49,14627
2023-05-21,15,8716,340,4771,296,345,50,14518
2023-05-21,16,8717,342,5243,716,298,50,15366
2023-05-21,17,8713,341,5694,592,191,50,15581
2023-05-21,18,8711,342,6073,439,87,49,15701
2023-05-21,19,8718,344,5658,352,29,51,15152
2023-05-21,20,8714,343,5508,366,3,50,14984
2023-05-21,21,8718,343,5689,412,0,50,15212
2023-05-21,22,8702,343,5494,524,0,50,15113
2023-05-21,23,8705,214,5366,689,0,50,15024
2023-05-21,24,8714,127,5183,911,0,50,14985
2023-05-22,1,8715,128,4828,978,0,50,14699
2023-05-22,2,8719,128,4591,1133,0,14,14585
2023-05-22,3,8719,128,4546,1153,0,0,14546
2023-05-22,4,8718,128,4506,1190,0,0,14542
2023-05-22,5,8721,128,4497,1314,0,0,14660
2023-05-22,6,8719,128,4209,1470,15,0,14541
2023-05-22,7,8720,128,4396,1314,68,0,14626
2023-05-22,8,8716,127,4728,987,173,0,14731
2023-05-22,9,8718,136,5120,672,285,0,14931
2023-05-22,10,8718,135,4689,411,369,0,14322
2023-05-22,11,8718,227,5177,331,403,0,14856
2023-05-22,12,8717,418,4786,372,415,0,14708
2023-05-22,13,8720,553,4856,308,392,2,14831
2023-05-22,14,8714,708,4712,383,397,31,14945
2023-05-22,15,8714,941,4672,443,389,53,15212
2023-05-22,16,8710,1083,5201,433,325,54,15806
2023-05-22,17,8703,1094,5468,415,223,54,15957
2023-05-22,18,8706,1126,5852,449,110,54,16297
2023-05-22,19,8710,1109,5887,574,31,53,16364
2023-05-22,20,8709,1099,5783,831,5,51,16478
2023-05-22,21,8710,1008,5358,1316,0,50,16442
2023-05-22,22,8714,587,4865,1871,0,51,16088
2023-05-22,23,8723,363,4451,2099,0,15,15651
2023-05-22,24,8720,364,4076,1975,0,0,15135
2023-05-23,1,8724,243,4052,2279,0,2,15300
2023-05-23,2,8722,133,3837,2280,0,10,14982
2023-05-23,3,8724,297,3852,2163,0,11,15047
2023-05-23,4,8723,417,3788,1732,0,11,14671
2023-05-23,5,8721,578,4215,1786,0,11,15311
2023-05-23,6,8719,628,4850,1729,17,14,15957
2023-05-23,7,8720,687,5194,1573,68,28,16270
2023-05-23,8,8718,728,5830,839,160,35,16310
2023-05-23,9,8716,860,6049,405,255,27,16312
2023-05-23,10,8715,1003,6032,178,326,16,16270
2023-05-23,11,8717,1047,5944,101,370,18,16197
2023-05-23,12,8718,1007,5340,142,379,26,15612
2023-05-23,13,8722,1141,5758,146,379,27,16173
2023-05-23,14,8720,1528,5510,145,363,26,16292
2023-05-23,15,8723,1855,5392,218,330,52,16570
2023-05-23,16,8720,2092,5743,217,264,70,17106
2023-05-23,17,8713,2176,5978,256,174,65,17362
2023-05-23,18,8711,2129,5873,328,92,66,17199
2023-05-23,19,8711,2116,5904,352,30,52,17165
2023-05-23,20,8721,2022,5814,422,3,51,17033
2023-05-23,21,8198,2073,6125,563,0,51,17010
2023-05-23,22,7898,1865,5778,779,0,51,16371
2023-05-23,23,7881,1251,5280,899,0,13,15324
2023-05-23,24,7888,832,5241,902,0,0,14863
2023-05-24,1,7895,292,5292,907,0,0,14386
2023-05-24,2,7904,156,5040,878,0,0,13978
2023-05-24,3,7904,156,5169,953,0,0,14182
2023-05-24,4,7904,255,4987,1073,0,0,14219
2023-05-24,5,7903,362,4588,995,0,0,13848
2023-05-24,6,7901,481,4884,1134,13,0,14413
2023-05-24,7,7901,480,5431,1482,35,1,15330
2023-05-24,8,7899,480,5603,1821,63,1,15867
2023-05-24,9,7894,479,5548,2469,117,1,16508
2023-05-24,10,7901,479,5247,2819,145,3,16594
2023-05-24,11,7900,480,5380,2694,153,2,16609
2023-05-24,12,7896,289,4723,2570,291,1,15770
2023-05-24,13,7894,132,4812,2701,317,1,15857
2023-05-24,14,7897,258,4845,2528,400,1,15929
2023-05-24,15,7899,395,4672,2492,410,2,15870
2023-05-24,16,7909,477,4672,2484,366,0,15908
2023-05-24,17,7899,478,5072,3381,259,6,17095
2023-05-24,18,7894,477,5404,3334,122,37,17268
2023-05-24,19,7897,478,5667,3182,31,53,17308
2023-05-24,20,7892,477,5922,2880,3,53,17227
2023-05-24,21,7888,478,6083,2807,0,53,17309
2023-05-24,22,7892,480,5369,2903,0,53,16697
2023-05-24,23,7895,480,4771,2844,0,53,16043
2023-05-24,24,7903,292,4928,2826,0,13,15962
2023-05-25,1,7901,130,5041,2728,0,2,15802
2023-05-25,2,7902,130,4822,2536,0,11,15401
2023-05-25,3,7906,271,4900,2165,0,11,15253
2023-05-25,4,7905,383,4380,1661,0,11,14340
2023-05-25,5,7910,539,4739,1657,0,11,14856
2023-05-25,6,7907,634,5146,1475,17,13,15192
2023-05-25,7,7909,872,5864,1069,74,20,15808
2023-05-25,8,7905,923,5642,867,198,23,15558
2023-05-25,9,7908,828,5442,614,319,20,15131
2023-05-25,10,7906,877,5222,432,395,43,14875
2023-05-25,11,7904,756,4614,496,423,74,14267
2023-05-25,12,7906,951,4714,784,429,75,14859
2023-05-25,13,7903,1324,4379,1078,428,73,15185
2023-05-25,14,7901,1510,4439,1280,430,72,15632
2023-05-25,15,7905,1654,4513,1098,416,68,15654
2023-05-25,16,7905,1737,4898,987,365,71,15963
2023-05-25,17,7906,1733,5521,1212,254,71,16697
2023-05-25,18,7906,1732,5641,1052,121,69,16521
2023-05-25,19,7901,1921,5969,945,29,65,16830
2023-05-25,20,7905,1740,6163,846,4,63,16721
2023-05-25,21,7907,1290,6121,855,0,64,16237
2023-05-25,22,7903,1241,6032,838,0,64,16078
2023-05-25,23,7900,539,5661,799,0,23,14922
2023-05-25,24,7907,252,5330,820,0,11,14320
2023-05-26,1,7906,144,5284,796,0,11,14141
2023-05-26,2,7912,285,5147,757,0,11,14112
2023-05-26,3,7909,348,4945,672,0,11,13885
2023-05-26,4,7915,326,5169,610,0,11,14031
2023-05-26,5,7914,536,5243,590,0,11,14294
2023-05-26,6,7914,684,5373,601,12,35,14619
2023-05-26,7,7911,780,5837,553,71,68,15220
2023-05-26,8,7908,847,5952,227,196,75,15205
2023-05-26,9,7906,835,5861,157,314,80,15153
2023-05-26,10,7910,902,5618,141,386,87,15044
2023-05-26,11,7907,838,5920,161,415,79,15320
2023-05-26,12,7904,847,5722,310,417,78,15278
2023-05-26,13,7901,763,5303,459,424,77,14927
2023-05-26,14,7901,770,5146,625,421,77,14940
2023-05-26,15,7905,996,4884,771,408,74,15038
2023-05-26,16,7907,1232,5234,823,351,72,15619
2023-05-26,17,7910,1494,5685,754,234,72,16149
2023-05-26,18,7922,1710,6020,633,112,79,16476
2023-05-26,19,7921,1817,6143,479,27,66,16453
2023-05-26,20,7919,1644,6201,384,4,65,16217
2023-05-26,21,7910,1566,6168,300,0,65,16009
2023-05-26,22,7917,1529,5610,435,0,26,15517
2023-05-26,23,7975,1006,5099,471,0,11,14562
2023-05-26,24,7999,273,4777,546,0,11,13606
2023-05-27,1,7994,128,4482,740,0,11,13355
2023-05-27,2,8002,128,4076,819,0,11,13036
2023-05-27,3,8070,127,4129,755,0,11,13092
2023-05-27,4,8158,128,4375,601,0,11,13273
2023-05-27,5,8178,167,4622,413,0,11,13391
2023-05-27,6,8176,168,4558,369,14,11,13296
2023-05-27,7,8179,165,4905,367,69,11,13696
2023-05-27,8,8176,151,5414,227,183,11,14162
2023-05-27,9,8172,152,5193,167,301,11,13996
2023-05-27,10,8171,141,5001,179,381,11,13884
2023-05-27,11,8170,139,5058,181,417,11,13976
2023-05-27,12,8168,276,5136,193,424,11,14208
2023-05-27,13,8159,600,4606,307,425,11,14108
2023-05-27,14,8156,960,4843,418,412,11,14800
2023-05-27,15,8155,1182,4673,485,398,11,14904
2023-05-27,16,8154,1289,5074,447,330,13,15307
2023-05-27,17,8159,1596,5703,437,224,11,16130
2023-05-27,18,8167,1689,6019,424,107,11,16417
2023-05-27,19,8168,1456,5561,402,35,11,15633
2023-05-27,20,8166,1354,5486,393,6,11,15416
2023-05-27,21,8251,1198,5645,436,0,11,15541
2023-05-27,22,8327,1077,5263,590,0,11,15268
2023-05-27,23,8345,388,4851,660,0,11,14255
2023-05-27,24,8342,122,4672,717,0,11,13864
2023-05-28,1,8348,123,4485,769,0,11,13736
2023-05-28,2,8337,123,4057,658,0,11,13186
2023-05-28,3,8330,122,3983,528,0,11,12974
2023-05-28,4,8330,123,4197,449,0,11,13110
2023-05-28,5,8365,122,4239,472,0,11,13209
2023-05-28,6,8411,123,4184,394,16,11,13139
2023-05-28,7,8415,123,4441,337,72,11,13399
2023-05-28,8,8409,123,4819,140,174,11,13676
2023-05-28,9,8411,123,4937,41,272,11,13795
2023-05-28,10,8408,207,4831,35,358,11,13850
2023-05-28,11,8409,225,4950,56,411,11,14062
2023-05-28,12,8405,384,5168,120,424,11,14512
2023-05-28,13,8401,914,5092,258,426,11,15102
2023-05-28,14,8409,1496,4826,395,416,11,15553
2023-05-28,15,8415,2115,5018,501,387,11,16447
2023-05-28,16,8410,2216,5244,562,313,11,16756
2023-05-28,17,8404,2221,5618,593,220,11,17067
2023-05-28,18,8408,2245,6046,546,111,11,17367
2023-05-28,19,8409,2241,6076,562,32,11,17331
2023-05-28,20,8406,2274,5654,718,8,11,17071
2023-05-28,21,8419,2246,5222,885,0,11,16783
2023-05-28,22,8421,1795,5001,927,0,11,16155
2023-05-28,23,8420,895,4691,991,0,11,15008
2023-05-28,24,8419,586,4451,972,0,11,14439
2023-05-29,1,8424,179,4203,996,0,11,13813
2023-05-29,2,8428,129,4203,1062,0,11,13833
2023-05-29,3,8428,128,4047,1182,0,11,13796
2023-05-29,4,8430,129,3918,1243,0,11,13731
2023-05-29,5,8426,128,3891,854,0,11,13310
2023-05-29,6,8425,128,4111,1096,10,12,13782
2023-05-29,7,8427,185,4755,1081,69,23,14540
2023-05-29,8,8426,682,5765,566,187,23,15649
2023-05-29,9,8422,1616,5222,342,304,20,15926
2023-05-29,10,8416,2136,4667,248,385,26,15878
2023-05-29,11,8410,2397,4494,256,416,49,16022
2023-05-29,12,8406,2358,4636,317,424,78,16219
2023-05-29,13,8404,2506,4820,413,424,99,16666
2023-05-29,14,8404,2687,4943,497,417,183,17131
2023-05-29,15,8401,2778,5020,624,403,147,17373
2023-05-29,16,8398,3101,5340,757,338,139,18073
2023-05-29,17,8392,3357,5668,788,232,124,18561
2023-05-29,18,8403,3645,5752,737,115,102,18754
2023-05-29,19,8410,3589,5860,622,30,84,18595
2023-05-29,20,8412,3232,5809,714,5,76,18248
2023-05-29,21,8411,2897,5516,903,0,65,17792
2023-05-29,22,8414,2286,5162,1042,0,65,16969
2023-05-29,23,8413,1368,4600,1273,0,65,15719
2023-05-29,24,8413,798,4140,1277,0,65,14693
2023-05-30,1,8415,559,4000,1623,0,30,14627
2023-05-30,2,8411,552,3546,1690,0,11,14210
2023-05-30,3,8414,550,3621,1534,0,11,14130
2023-05-30,4,8410,552,3762,1628,0,11,14363
2023-05-30,5,8407,634,4129,1561,0,11,14742
2023-05-30,6,8408,919,4220,1183,10,14,14754
2023-05-30,7,8408,1459,4771,1254,71,29,15992
2023-05-30,8,8406,2142,4900,799,182,35,16464
2023-05-30,9,8403,2400,5139,526,297,24,16789
2023-05-30,10,8373,2605,5063,381,377,21,16820
2023-05-30,11,8389,2919,4840,357,410,26,16941
2023-05-30,12,8413,3500,5012,252,420,34,17631
2023-05-30,13,8411,3997,4979,263,422,47,18119
2023-05-30,14,8409,3790,5159,292,417,86,18153
2023-05-30,15,8407,3775,5330,348,392,82,18334
2023-05-30,16,8401,4285,5608,392,321,74,19081
2023-05-30,17,8395,4524,5811,381,219,86,19416
2023-05-30,18,8392,4706,5804,364,109,117,19492
2023-05-30,19,8397,4686,5742,518,31,108,19482
2023-05-30,20,8399,4352,5639,631,4,69,19094
2023-05-30,21,8396,3918,5242,879,0,64,18499
2023-05-30,22,8392,3380,4929,1268,0,64,18033
2023-05-30,23,8392,2643,4278,1264,0,25,16602
2023-05-30,24,8395,1520,4418,1440,0,10,15783
2023-05-31,1,8399,698,4580,1367,0,10,15054
2023-05-31,2,8403,605,3979,1303,0,10,14300
2023-05-31,3,8408,605,3710,1584,0,10,14317
2023-05-31,4,8409,632,3715,1497,0,10,14263
2023-05-31,5,8410,990,3998,983,0,10,14391
2023-05-31,6,8409,1835,4070,1026,13,15,15368
2023-05-31,7,8409,2464,4333,924,69,32,16231
2023-05-31,8,8404,2768,4908,766,178,33,17057
2023-05-31,9,8401,3034,5158,585,290,24,17492
2023-05-31,10,8409,3476,5132,478,368,47,17910
2023-05-31,11,8405,4276,4765,390,403,75,18314
2023-05-31,12,8402,4252,4917,421,413,77,18482
2023-05-31,13,8389,4592,5144,464,409,89,19087
2023-05-31,14,8393,4565,5522,492,404,88,19464
2023-05-31,15,8386,4999,5309,465,387,110,19656
2023-05-31,16,8392,5180,5344,418,321,151,19806
2023-05-31,17,8388,5320,5491,448,227,166,20040
2023-05-31,18,8396,4980,5859,417,112,116,19880
2023-05-31,19,8399,4794,5730,507,32,36,19498
2023-05-31,20,8399,4714,5775,517,7,22,19434
2023-05-31,21,8396,5056,5799,524,0,22,19797
2023-05-31,22,8403,4926,5432,457,0,22,19240
2023-05-31,23,8405,4120,4878,518,0,22,17943
2023-05-31,24,8405,3474,4265,551,0,21,16716
2023-06-01,1,8397,3068,3559,512,0,21,15557
2023-06-01,2,8394,2457,3879,465,0,21,15216
2023-06-01,3,8395,2285,3812,290,0,21,14803
2023-06-01,4,8396,2539,3617,169,0,21,14742
2023-06-01,5,8331,2970,3280,52,0,22,14655
2023-06-01,6,8094,3213,3628,132,14,52,15133
2023-06-01,7,8333,3446,4433,156,67,95,16530
2023-06-01,8,8385,3730,5094,96,172,99,17576
2023-06-01,9,8391,4077,5235,38,281,85,18107
2023-06-01,10,8392,4590,5091,43,358,102,18576
2023-06-01,11,8396,4723,4953,50,399,117,18638
2023-06-01,12,8394,5021,4673,136,418,122,18764
2023-06-01,13,8394,4913,4732,297,403,91,18830
2023-06-01,14,8395,5461,4903,436,401,111,19707
2023-06-01,15,8398,5200,5065,511,357,104,19635
2023-06-01,16,8389,5128,5710,610,269,102,20208
2023-06-01,17,8388,5025,5747,571,186,97,20014
2023-06-01,18,8386,4814,5677,482,108,100,19567
2023-06-01,19,8384,4793,5788,439,29,102,19535
2023-06-01,20,8377,4815,5430,547,4,103,19276
2023-06-01,21,8382,5496,5184,596,0,89,19747
2023-06-01,22,8380,4544,5202,695,0,78,18899
2023-06-01,23,8381,3926,4484,843,0,71,17705
2023-06-01,24,8384,3042,4211,942,0,71,16650
2023-06-02,1,8390,2822,4024,953,0,71,16260
2023-06-02,2,8397,2596,3872,905,0,72,15842
2023-06-02,3,8398,2450,3627,738,0,72,15285
2023-06-02,4,8406,2559,3591,732,0,71,15359
2023-06-02,5,8403,2757,3508,759,0,72,15499
2023-06-02,6,8409,3310,3800,683,14,74,16290
2023-06-02,7,8411,3611,4078,519,64,94,16777
2023-06-02,8,8409,4089,4501,237,171,101,17508
2023-06-02,9,8402,4500,4688,129,266,86,18071
2023-06-02,10,8393,4996,4622,222,347,98,18678
2023-06-02,11,8388,5191,4990,305,395,100,19369
2023-06-02,12,8379,5225,5028,468,408,100,19608
2023-06-02,13,8374,5158,5306,695,409,101,20043
2023-06-02,14,8375,4950,5384,902,384,100,20095
2023-06-02,15,8385,5059,5379,1063,337,112,20335
2023-06-02,16,8430,5227,5482,1245,267,114,20765
2023-06-02,17,8450,5118,5412,1337,196,106,20619
2023-06-02,18,8458,4882,5325,1485,94,118,20362
2023-06-02,19,8456,4304,5364,1302,29,109,19564
2023-06-02,20,8454,4404,5185,1260,4,93,19400
2023-06-02,21,8449,4693,5085,1366,0,92,19685
2023-06-02,22,8448,4365,4559,1565,0,58,18995
2023-06-02,23,8456,3533,3944,1643,0,20,17596
2023-06-02,24,8452,3031,3695,1788,0,20,16986
2023-06-03,1,8460,2017,3467,1753,0,19,15716
2023-06-03,2,8465,1380,3560,1763,0,19,15187
2023-06-03,3,8463,941,3582,1765,0,19,14770
2023-06-03,4,8449,762,3746,1794,0,19,14770
2023-06-03,5,8447,1040,3329,1764,0,19,14599
2023-06-03,6,8450,1424,3308,1451,11,19,14663
2023-06-03,7,8449,1677,3461,1061,65,20,14733
2023-06-03,8,8438,1990,3656,1115,165,40,15404
2023-06-03,9,8436,2096,4048,1264,270,68,16182
2023-06-03,10,8427,2350,4460,1275,351,73,16936
2023-06-03,11,8426,2610,4396,1324,398,73,17227
2023-06-03,12,8422,2397,4452,1595,395,73,17334
2023-06-03,13,8417,2234,4557,1914,399,73,17594
2023-06-03,14,8426,2197,4526,2186,411,73,17819
2023-06-03,15,8430,2235,4213,2368,398,73,17717
2023-06-03,16,8435,2330,4555,2294,338,90,18042
2023-06-03,17,8435,2543,4772,2305,237,77,18369
2023-06-03,18,8437,2761,4897,2226,114,104,18539
2023-06-03,19,8431,2515,4887,2202,33,76,18144
2023-06-03,20,8431,2309,4688,2095,6,75,17604
2023-06-03,21,8430,1853,4489,2169,0,92,17033
2023-06-03,22,8425,1162,4513,2133,0,74,16307
2023-06-03,23,8430,665,4332,2233,0,31,15691
2023-06-03,24,8432,179,4155,2186,0,21,14973
2023-06-04,1,8434,135,3624,2153,0,21,14367
2023-06-04,2,8435,132,3218,2042,0,21,13848
2023-06-04,3,8431,132,3425,1787,0,21,13796
2023-06-04,4,8380,132,3521,1629,0,21,13683
2023-06-04,5,8374,132,3512,1458,0,21,13497
2023-06-04,6,8379,132,3391,852,18,21,12793
2023-06-04,7,8384,132,3824,918,71,21,13350
2023-06-04,8,8378,132,4213,929,180,21,13853
2023-06-04,9,8376,132,3766,1065,292,21,13652
2023-06-04,10,8369,250,3895,1265,380,24,14183
2023-06-04,11,8364,483,3660,1435,419,34,14395
2023-06-04,12,8353,827,3681,1752,422,29,15064
2023-06-04,13,8350,953,3681,1672,416,20,15092
2023-06-04,14,8347,1487,3700,1367,410,19,15330
2023-06-04,15,8339,1728,4202,1282,384,19,15954
2023-06-04,16,8340,1938,4978,1303,312,19,16890
2023-06-04,17,8332,2362,5454,1204,210,39,17601
2023-06-04,18,8342,2399,5542,1040,99,69,17491
2023-06-04,19,8345,2659,5512,790,32,72,17410
2023-06-04,20,8358,2819,5311,672,7,69,17236
2023-06-04,21,8356,2678,5095,644,0,70,16843
2023-06-04,22,8356,2361,4606,612,0,65,16000
2023-06-04,23,8362,1951,4526,399,0,21,15259
2023-06-04,24,8366,1249,4527,311,0,19,14472
2023-06-05,1,8368,1022,4266,216,0,19,13891
2023-06-05,2,8367,756,4177,142,0,19,13461
2023-06-05,3,8368,837,4166,132,0,19,13522
2023-06-05,4,8366,1055,3907,167,0,19,13514
2023-06-05,5,8369,1408,3479,143,0,19,13418
2023-06-05,6,8368,1955,3583,204,16,21,14147
2023-06-05,7,8367,2160,4185,210,59,26,15007
2023-06-05,8,8367,2548,4636,129,125,32,15837
2023-06-05,9,8359,2766,4737,72,193,24,16151
2023-06-05,10,8358,3138,4439,66,251,30,16282
2023-06-05,11,8351,3332,4415,67,278,30,16473
2023-06-05,12,8354,3519,4487,96,327,30,16813
2023-06-05,13,8344,3811,4421,128,352,25,17081
2023-06-05,14,8339,4071,4450,173,290,28,17351
2023-06-05,15,8333,4436,4384,302,255,55,17765
2023-06-05,16,8329,4109,4412,397,240,77,17564
2023-06-05,17,8329,4322,4579,476,168,76,17950
2023-06-05,18,8340,4048,5148,461,72,83,18152
2023-06-05,19,8349,4213,5157,522,26,78,18345
2023-06-05,20,8345,4026,5029,645,6,78,18129
2023-06-05,21,8349,4101,4628,693,0,83,17854
2023-06-05,22,8342,3522,4196,794,0,73,16927
2023-06-05,23,8442,2678,3735,943,0,69,15867
2023-06-05,24,8569,1791,3617,864,0,68,14909
2023-06-06,1,8569,787,3566,800,0,29,13751
2023-06-06,2,8571,242,3600,853,0,18,13284
2023-06-06,3,8542,450,3345,962,0,18,13317
2023-06-06,4,8546,818,3283,859,0,18,13524
2023-06-06,5,8540,981,3337,898,0,18,13774
2023-06-06,6,8543,1253,3810,956,11,18,14591
2023-06-06,7,8539,1913,4240,915,30,19,15656
2023-06-06,8,8536,2242,4329,708,106,20,15941
2023-06-06,9,8547,2380,4399,574,187,25,16112
2023-06-06,10,8562,2273,4284,707,252,25,16103
2023-06-06,11,8571,1864,3856,902,352,22,15567
2023-06-06,12,8566,1851,3810,1587,391,22,16227
2023-06-06,13,8560,2045,3861,2114,406,20,17006
2023-06-06,14,8556,2260,3992,2254,374,20,17456
2023-06-06,15,8555,2355,3946,2444,338,24,17662
2023-06-06,16,8540,2411,4307,2751,280,30,18319
2023-06-06,17,8549,2594,4644,2809,195,31,18822
2023-06-06,18,8688,2577,4756,2671,85,33,18810
2023-06-06,19,8759,2855,4747,2317,29,33,18740
2023-06-06,20,8753,2917,4645,1959,6,30,18310
2023-06-06,21,8867,2862,4451,1945,0,29,18154
2023-06-06,22,8926,2277,4067,2012,0,19,17301
2023-06-06,23,8913,1517,3466,1820,0,18,15734
2023-06-06,24,8898,781,3331,1675,0,18,14703
2023-06-07,1,8907,227,3376,1760,0,18,14288
2023-06-07,2,8911,157,3241,1735,0,18,14062
2023-06-07,3,8906,165,3388,1613,0,17,14089
2023-06-07,4,8915,416,3531,1498,0,18,14378
2023-06-07,5,8916,813,3234,1306,0,18,14287
2023-06-07,6,8930,1589,3370,1214,18,19,15140
2023-06-07,7,8933,2018,3852,1051,65,27,15946
2023-06-07,8,8944,2352,4261,568,141,28,16294
2023-06-07,9,8967,2363,4265,384,236,18,16233
2023-06-07,10,8964,2508,4147,505,334,27,16485
2023-06-07,11,8957,2456,3686,422,393,28,15942
2023-06-07,12,8956,2412,3635,1054,408,30,16495
2023-06-07,13,8948,2046,3595,1830,385,30,16834
2023-06-07,14,8968,2023,3591,2303,308,32,17225
2023-06-07,15,8974,2015,3714,2363,274,40,17380
2023-06-07,16,8974,2485,3907,2410,233,44,18053
2023-06-07,17,8970,2394,4291,2497,172,47,18371
2023-06-07,18,8970,2164,4358,2511,91,54,18148
2023-06-07,19,8971,2153,4603,2356,24,33,18140
2023-06-07,20,8972,2132,4760,1863,4,30,17761
2023-06-07,21,8976,2618,4515,1390,0,29,17528
2023-06-07,22,8988,2535,3867,1299,0,23,16712
2023-06-07,23,8995,1776,3530,1085,0,16,15402
2023-06-07,24,8997,1574,3435,665,0,16,14687
2023-06-08,1,8990,740,3517,638,0,16,13901
2023-06-08,2,8990,600,3523,591,0,16,13720
2023-06-08,3,8986,544,3529,522,0,16,13597
2023-06-08,4,8976,685,3383,475,0,16,13535
2023-06-08,5,8969,1069,3251,273,0,16,13578
2023-06-08,6,8968,1781,3333,460,5,21,14568
2023-06-08,7,8962,2644,3849,434,39,52,15980
2023-06-08,8,8958,2937,3758,284,95,54,16086
2023-06-08,9,8965,3140,3693,264,149,43,16254
2023-06-08,10,8961,3225,3781,293,202,54,16516
2023-06-08,11,8960,3464,3768,377,191,59,16819
2023-06-08,12,8965,3901,3785,473,184,58,17366
2023-06-08,13,8961,3545,3793,745,155,60,17259
2023-06-08,14,8902,3208,3808,995,182,59,17154
2023-06-08,15,8957,3108,3613,1157,193,68,17096
2023-06-08,16,8957,3147,3848,1200,139,30,17321
2023-06-08,17,8956,3517,4226,1085,112,29,17925
2023-06-08,18,8957,3351,4368,938,63,29,17706
2023-06-08,19,8953,3269,4536,703,24,28,17513
2023-06-08,20,8949,3315,4508,551,4,29,17356
2023-06-08,21,8947,3342,4368,540,0,29,17226
2023-06-08,22,8951,2869,3898,547,0,23,16288
2023-06-08,23,8955,1921,3675,310,0,17,14878
2023-06-08,24,8956,1291,3621,475,0,16,14359
2023-06-09,1,8965,665,3593,348,0,16,13587
2023-06-09,2,8966,573,3464,309,0,16,13328
2023-06-09,3,8974,573,3325,396,0,16,13284
2023-06-09,4,8979,753,3263,527,0,16,13538
2023-06-09,5,8986,1334,3302,322,0,16,13960
2023-06-09,6,8988,2067,3349,392,14,16,14826
2023-06-09,7,8994,2452,3716,482,57,16,15717
2023-06-09,8,8993,3094,3781,227,125,16,16236
2023-06-09,9,8993,3300,3766,300,174,16,16549
2023-06-09,10,8985,3305,3805,387,184,16,16682
2023-06-09,11,8982,3324,3706,485,158,17,16672
2023-06-09,12,8943,3306,3559,498,198,17,16521
2023-06-09,13,8932,3026,3608,556,237,17,16376
2023-06-09,14,8934,3122,3643,511,284,17,16511
2023-06-09,15,8939,3116,3716,552,268,24,16615
2023-06-09,16,8922,3169,3885,646,236,29,16887
2023-06-09,17,8917,3199,4317,780,175,29,17417
2023-06-09,18,8919,3040,4389,785,87,30,17250
2023-06-09,19,8926,2961,4433,596,33,29,16978
2023-06-09,20,8931,3568,4150,514,9,23,17195
2023-06-09,21,8931,3809,4032,438,0,23,17233
2023-06-09,22,8941,3532,3615,403,0,15,16506
2023-06-09,23,8943,2534,3367,428,0,7,15279
2023-06-09,24,8950,1902,3069,354,0,7,14282
2023-06-10,1,8942,998,3349,581,0,7,13877
2023-06-10,2,8939,603,3333,769,0,7,13651
2023-06-10,3,8939,349,3243,803,0,7,13341
2023-06-10,4,8945,240,2948,705,0,7,12845
2023-06-10,5,8941,371,3043,472,0,7,12834
2023-06-10,6,8935,531,2972,580,17,7,13042
2023-06-10,7,8937,679,3220,521,61,7,13425
2023-06-10,8,8939,1169,3525,358,135,7,14133
2023-06-10,9,8928,1784,3663,295,200,7,14877
2023-06-10,10,8930,2361,3499,264,292,7,15353
2023-06-10,11,8930,2434,3518,349,346,7,15584
2023-06-10,12,8927,2549,3468,485,350,7,15786
2023-06-10,13,8929,2541,3487,699,361,7,16024
2023-06-10,14,8933,2506,3419,874,355,7,16094
2023-06-10,15,8931,2463,3442,1126,328,7,16297
2023-06-10,16,8929,2586,3718,1196,269,10,16708
2023-06-10,17,8928,2743,4279,1131,174,13,17268
2023-06-10,18,8939,3171,4216,970,89,14,17399
2023-06-10,19,8939,3182,4307,839,41,14,17322
2023-06-10,20,8937,2875,4208,891,6,14,16931
2023-06-10,21,8941,3145,3826,926,0,14,16852
2023-06-10,22,8947,3329,3533,842,0,14,16665
2023-06-10,23,8946,2775,3331,848,0,14,15914
2023-06-10,24,8948,1636,3410,799,0,14,14807
2023-06-11,1,8948,341,3542,757,0,15,13603
2023-06-11,2,8957,174,3723,649,0,15,13518
2023-06-11,3,8941,199,3639,541,0,15,13335
2023-06-11,4,8954,239,3527,377,0,15,13112
2023-06-11,5,8975,292,3278,360,0,15,12920
2023-06-11,6,8987,541,3140,418,5,16,13107
2023-06-11,7,8990,1228,3043,83,19,16,13379
2023-06-11,8,8991,1804,3115,271,44,16,14241
2023-06-11,9,8990,2096,3283,445,74,17,14905
2023-06-11,10,8979,2451,3377,569,112,17,15505
2023-06-11,11,8980,2587,3540,543,148,17,15815
2023-06-11,12,8981,2872,3417,589,154,17,16030
2023-06-11,13,8981,2752,3414,620,179,17,15963
2023-06-11,14,8979,2497,3420,824,165,17,15902
2023-06-11,15,8976,2725,3462,1130,119,17,16429
2023-06-11,16,8973,2467,3385,1146,105,17,16093
2023-06-11,17,8973,2435,3647,1202,66,17,16340
2023-06-11,18,8997,2520,3797,1140,41,17,16512
2023-06-11,19,9016,2621,3897,1456,15,17,17022
2023-06-11,20,8988,2531,3886,1714,1,17,17137
2023-06-11,21,8549,2506,3666,1978,0,17,16716
2023-06-11,22,8131,2466,3374,2055,0,17,16043
2023-06-11,23,8141,1809,3052,2032,0,17,15051
2023-06-11,24,8151,635,3053,1971,0,17,13827
2023-06-12,1,8146,326,2953,2044,0,17,13486
2023-06-12,2,8153,325,2900,2162,0,18,13558
2023-06-12,3,8152,459,2882,1964,0,18,13475
2023-06-12,4,8149,680,2938,2106,0,18,13891
2023-06-12,5,8143,1028,2881,1954,0,18,14024
2023-06-12,6,8133,1219,2921,2156,2,18,14449
2023-06-12,7,8124,1823,3274,2431,28,18,15698
2023-06-12,8,8112,2234,3318,2452,58,18,16192
2023-06-12,9,8113,3054,3349,2231,103,18,16868
2023-06-12,10,8106,3165,3404,2251,96,17,17039
2023-06-12,11,8098,3207,3361,2193,109,17,16985
2023-06-12,12,8100,3435,3321,2167,113,17,17153
2023-06-12,13,8104,3093,3373,1988,117,17,16692
2023-06-12,14,8102,3439,3470,1665,102,17,16795
2023-06-12,15,8102,3725,3536,1484,90,30,16967
2023-06-12,16,8103,3797,3846,1477,98,58,17379
2023-06-12,17,8102,3636,4114,1570,90,88,17600
2023-06-12,18,8099,3618,4246,1525,58,90,17636
2023-06-12,19,8099,3499,4252,1407,22,87,17366
2023-06-12,20,8087,3633,4233,1250,5,85,17293
2023-06-12,21,8091,3707,3891,1123,0,47,16859
2023-06-12,22,8095,3461,3511,1032,0,23,16122
2023-06-12,23,8092,2302,3375,1143,0,17,14929
2023-06-12,24,8097,1749,3170,1194,0,18,14228
2023-06-13,1,8101,919,3085,1303,0,9,13417
2023-06-13,2,8103,638,3064,1301,0,4,13110
2023-06-13,3,8104,661,2921,1486,0,12,13184
2023-06-13,4,8108,804,2993,1480,0,18,13403
2023-06-13,5,8112,1340,3262,1414,0,23,14151
2023-06-13,6,8112,2115,3000,1220,12,42,14501
2023-06-13,7,8112,2545,3498,1301,61,46,15563
2023-06-13,8,8116,2506,3657,1101,157,46,15583
2023-06-13,9,8112,2598,3484,1246,223,30,15693
2023-06-13,10,8112,2822,3545,786,299,38,15602
2023-06-13,11,8110,2825,3540,1411,296,44,16226
2023-06-13,12,8110,2833,3744,1367,306,46,16406
2023-06-13,13,8112,3129,3959,1440,265,46,16951
2023-06-13,14,8115,3258,4017,1242,210,46,16888
2023-06-13,15,8115,3317,4074,1078,163,52,16799
2023-06-13,16,8113,3350,4212,1217,165,53,17110
2023-06-13,17,8102,3382,4444,1098,137,30,17193
2023-06-13,18,8108,3462,4452,693,90,30,16835
2023-06-13,19,8107,3491,4585,719,32,30,16964
2023-06-13,20,8103,3229,4494,693,6,31,16556
2023-06-13,21,8104,3445,4459,567,0,31,16606
2023-06-13,22,8098,3571,3996,417,0,23,16105
2023-06-13,23,8098,2654,3653,384,0,18,14807
2023-06-13,24,8094,2117,3350,306,0,18,13885
2023-06-14,1,8092,1956,3239,292,0,18,13597
2023-06-14,2,8086,2096,3030,244,0,18,13474
2023-06-14,3,8091,2159,3047,274,0,18,13589
2023-06-14,4,8095,2157,3080,542,0,18,13892
2023-06-14,5,8093,2221,3081,467,0,18,13880
2023-06-14,6,8096,2565,3110,432,3,18,14224
2023-06-14,7,8096,3068,3552,558,25,18,15317
2023-06-14,8,8093,3266,3747,535,67,18,15726
2023-06-14,9,8091,3190,3814,666,110,18,15889
2023-06-14,10,8101,3163,3882,746,170,18,16080
2023-06-14,11,8103,3335,3945,759,210,44,16396
2023-06-14,12,8101,3682,3917,834,194,46,16774
2023-06-14,13,8089,3787,4101,862,211,46,17096
2023-06-14,14,8079,3631,4341,988,183,45,17267
2023-06-14,15,8078,3277,4587,1075,175,53,17245
2023-06-14,16,8075,3190,4940,1066,135,57,17463
2023-06-14,17,8072,3399,5112,830,116,80,17609
2023-06-14,18,8072,3491,5266,744,88,82,17743
2023-06-14,19,8068,3221,5400,550,38,81,17358
2023-06-14,20,8067,3752,5158,345,5,83,17410
2023-06-14,21,8064,4260,4692,317,0,103,17436
2023-06-14,22,8060,4126,3967,366,0,74,16593
2023-06-14,23,8069,2946,3748,340,0,68,15171
2023-06-14,24,8077,2359,3401,263,0,27,14127
2023-06-15,1,8086,1929,3405,171,0,17,13608
2023-06-15,2,8096,2127,3339,170,0,17,13749
2023-06-15,3,8102,2172,3337,398,0,17,14026
2023-06-15,4,8109,2155,3482,370,0,17,14133
2023-06-15,5,8103,2290,3564,478,0,17,14452
2023-06-15,6,8112,2585,3585,345,8,19,14654
2023-06-15,7,8103,3124,3849,292,33,38,15439
2023-06-15,8,8089,3495,3789,247,56,43,15719
2023-06-15,9,8083,3609,4018,224,105,29,16068
2023-06-15,10,8077,3756,4034,228,167,65,16327
2023-06-15,11,8076,3704,4102,279,220,100,16481
2023-06-15,12,8068,3823,4099,366,214,97,16667
2023-06-15,13,8066,4109,4166,391,211,95,17038
2023-06-15,14,8064,4235,4262,495,188,78,17322
2023-06-15,15,8065,4274,4321,566,200,83,17509
2023-06-15,16,8064,4286,4570,522,175,91,17708
2023-06-15,17,8063,4236,5045,390,88,94,17916
2023-06-15,18,8062,4176,5057,484,63,90,17932
2023-06-15,19,8060,3974,5254,561,27,90,17966
2023-06-15,20,8062,3996,5058,883,6,82,18087
2023-06-15,21,8077,4030,4478,1155,0,80,17820
2023-06-15,22,8087,3013,4188,870,0,72,16230
2023-06-15,23,8099,2612,3793,608,0,28,15140
2023-06-15,24,8093,1724,3707,856,0,17,14397
2023-06-16,1,8089,944,3487,908,0,17,13445
2023-06-16,2,8089,732,3562,880,0,17,13280
2023-06-16,3,8087,728,3382,866,0,17,13080
2023-06-16,4,8087,709,3411,1011,0,17,13235
2023-06-16,5,8085,1015,3465,702,0,17,13284
2023-06-16,6,8080,1664,3649,876,4,17,14290
2023-06-16,7,8073,2320,3983,796,19,17,15208
2023-06-16,8,8068,2672,4035,807,59,17,15658
2023-06-16,9,8068,2923,3980,853,122,23,15969
2023-06-16,10,8059,2974,3914,960,167,63,16137
2023-06-16,11,8059,2910,3929,1197,236,73,16404
2023-06-16,12,8067,3174,4079,1268,246,72,16906
2023-06-16,13,8080,3330,3935,1376,257,67,17045
2023-06-16,14,8088,3037,3978,1632,260,67,17062
2023-06-16,15,8089,2912,4141,1801,221,73,17237
2023-06-16,16,8080,2965,4494,1733,179,79,17530
2023-06-16,17,8069,3524,4622,1542,160,80,17997
2023-06-16,18,8067,3747,4633,1570,93,80,18190
2023-06-16,19,8064,3588,4794,1275,39,81,17841
2023-06-16,20,8059,3617,4822,943,8,81,17530
2023-06-16,21,8050,3841,4447,859,0,86,17283
2023-06-16,22,8045,3404,4071,945,0,75,16540
2023-06-16,23,8039,2585,3371,1080,0,67,15142
2023-06-16,24,8025,1414,3426,1212,0,66,14143
2023-06-17,1,8038,1172,3342,1170,0,65,13787
2023-06-17,2,8041,793,3418,987,0,26,13265
2023-06-17,3,8044,773,3419,927,0,16,13179
2023-06-17,4,8049,719,3340,873,0,16,12997
2023-06-17,5,8058,784,3428,798,0,16,13084
2023-06-17,6,8068,851,3435,798,19,15,13186
2023-06-17,7,8076,1169,3500,636,76,15,13472
2023-06-17,8,8070,1838,3688,292,163,16,14067
2023-06-17,9,8074,2211,3806,247,270,16,14624
2023-06-17,10,8077,2204,3722,364,354,16,14737
2023-06-17,11,8071,2254,3939,514,392,17,15187
2023-06-17,12,8059,2450,3994,593,339,16,15451
2023-06-17,13,8049,2547,3908,638,343,16,15501
2023-06-17,14,8041,2779,3835,685,330,16,15686
2023-06-17,15,8039,2983,3823,714,302,21,15882
2023-06-17,16,8033,3287,4024,763,243,50,16400
2023-06-17,17,8058,3288,4366,805,160,65,16742
2023-06-17,18,8064,3231,4342,720,98,65,16520
2023-06-17,19,8068,3172,4342,585,36,65,16268
2023-06-17,20,8069,3335,4325,554,9,65,16357
2023-06-17,21,8076,3311,4244,427,0,67,16125
2023-06-17,22,8079,3428,3840,336,0,66,15749
2023-06-17,23,8083,2719,3584,260,0,26,14672
2023-06-17,24,8087,1978,3339,260,0,17,13681
2023-06-18,1,8227,1109,3346,276,0,17,12975
2023-06-18,2,8297,558,3193,234,0,16,12298
2023-06-18,3,8287,725,3229,216,0,16,12473
2023-06-18,4,8307,689,3194,164,0,16,12370
2023-06-18,5,8487,544,3257,93,0,16,12397
2023-06-18,6,8535,609,3306,48,15,16,12529
2023-06-18,7,8547,791,3261,35,59,16,12709
2023-06-18,8,8533,1298,3496,46,140,16,13529
2023-06-18,9,8510,2169,3400,21,228,16,14344
2023-06-18,10,8521,2427,3643,12,335,16,14954
2023-06-18,11,8550,2568,3844,15,364,16,15357
2023-06-18,12,8553,2874,3925,86,377,16,15831
2023-06-18,13,8674,2833,3904,182,355,16,15964
2023-06-18,14,8697,3141,3843,151,324,32,16188
2023-06-18,15,8705,3524,3902,198,326,62,16717
2023-06-18,16,8707,3639,4317,286,296,66,17311
2023-06-18,17,8711,3933,4229,248,208,65,17394
2023-06-18,18,8716,4262,4335,148,115,80,17656
2023-06-18,19,8718,4392,4317,150,42,97,17716
2023-06-18,20,8753,4095,4270,235,10,79,17442
2023-06-18,21,8883,4207,4028,353,0,83,17554
2023-06-18,22,8886,3997,3809,425,0,38,17155
2023-06-18,23,8893,2889,3522,469,0,16,15789
2023-06-18,24,8889,1678,3103,590,0,17,14277
2023-06-19,1,8899,1023,3186,546,0,18,13672
2023-06-19,2,8903,937,3198,570,0,18,13626
2023-06-19,3,8902,973,3262,593,0,18,13748
2023-06-19,4,8901,997,3105,711,0,18,13732
2023-06-19,5,8896,1082,2922,605,0,18,13523
2023-06-19,6,8891,1552,3105,481,16,18,14063
2023-06-19,7,8887,2039,3405,870,70,18,15289
2023-06-19,8,8896,2998,3832,574,172,18,16490
2023-06-19,9,8918,3767,3977,390,265,18,17335
2023-06-19,10,8926,4011,3795,409,350,18,17509
2023-06-19,11,8933,4062,3857,510,390,18,17770
2023-06-19,12,8934,4193,3919,637,411,18,18112
2023-06-19,13,8939,4457,3867,698,391,24,18376
2023-06-19,14,8958,4471,3958,838,378,38,18641
2023-06-19,15,8956,4323,4005,1083,370,69,18806
2023-06-19,16,8948,4350,4466,1141,289,105,19299
2023-06-19,17,8962,4278,4847,1121,222,106,19536
2023-06-19,18,8964,4456,4612,1037,117,95,19281
2023-06-19,19,8964,4240,4854,1065,43,85,19251
2023-06-19,20,8963,4065,4945,1221,9,85,19288
2023-06-19,21,8961,4043,4667,1517,0,84,19272
2023-06-19,22,8957,3264,4299,1660,0,33,18213
2023-06-19,23,8957,2601,3479,1802,0,17,16856
2023-06-19,24,8958,1599,3014,1923,0,17,15511
2023-06-20,1,8971,844,3282,2038,0,17,15152
2023-06-20,2,8975,447,3318,2114,0,17,14871
2023-06-20,3,8975,361,3210,2142,0,17,14705
2023-06-20,4,8985,356,3169,2079,0,17,14606
2023-06-20,5,8981,617,3027,2147,0,17,14789
2023-06-20,6,8988,1400,2991,2014,13,18,15424
2023-06-20,7,8991,2238,3417,1624,70,18,16358
2023-06-20,8,8987,2686,3549,1529,165,18,16934
2023-06-20,9,8978,3038,3568,1543,269,18,17414
2023-06-20,10,8971,3279,3621,1550,366,18,17805
2023-06-20,11,8969,3509,3884,1410,403,18,18193
2023-06-20,12,8965,3845,3903,1337,420,19,18489
2023-06-20,13,8958,4261,3932,1210,422,45,18828
2023-06-20,14,8962,4702,4142,1103,414,84,19407
2023-06-20,15,8980,4792,4195,1233,396,108,19704
2023-06-20,16,8980,4374,4737,1315,332,92,19830
2023-06-20,17,8981,4546,4991,1398,234,98,20248
2023-06-20,18,8988,4680,4868,1628,122,98,20384
2023-06-20,19,8988,4676,4932,1608,43,85,20332
2023-06-20,20,8990,4428,4790,1492,9,86,19795
2023-06-20,21,8986,4534,4408,1496,0,96,19520
2023-06-20,22,8995,3764,4044,1589,0,34,18426
2023-06-20,23,8996,2782,3611,1626,0,17,17032
2023-06-20,24,8998,1818,3211,1820,0,17,15864
2023-06-21,1,8994,1426,3075,1853,0,17,15365
2023-06-21,2,9001,1126,3049,1791,0,17,14984
2023-06-21,3,8998,1363,2903,1480,0,17,14761
2023-06-21,4,9002,1364,3038,1612,0,17,15033
2023-06-21,5,8998,1378,3125,1440,0,17,14958
2023-06-21,6,8995,1639,3205,1247,14,17,15117
2023-06-21,7,8997,2298,3543,878,62,26,15804
2023-06-21,8,8999,3532,3826,438,152,25,16972
2023-06-21,9,8990,4203,3715,309,266,27,17510
2023-06-21,10,8986,4281,3933,397,356,33,17986
2023-06-21,11,8992,4370,4105,584,406,47,18504
2023-06-21,12,8997,4590,4174,798,414,68,19041
2023-06-21,13,9004,4900,4097,909,371,105,19386
2023-06-21,14,8990,4918,4201,1161,344,86,19700
2023-06-21,15,8968,4938,4299,1390,337,106,20038
2023-06-21,16,8943,4979,4549,1371,298,138,20278
2023-06-21,17,8910,4951,4758,1152,203,165,20139
2023-06-21,18,8907,4756,4828,1016,120,132,19759
2023-06-21,19,8906,4727,4513,1021,42,126,19335
2023-06-21,20,8900,4960,4367,883,9,132,19251
2023-06-21,21,8900,5048,4267,1036,0,160,19411
2023-06-21,22,8895,4293,3979,1237,0,112,18516
2023-06-21,23,8900,3210,3610,1410,0,27,17157
2023-06-21,24,8901,2640,3205,1556,0,18,16320
2023-06-22,1,8898,1861,3116,1545,0,18,15438
2023-06-22,2,8906,1698,3303,1355,0,18,15280
2023-06-22,3,8979,1720,3466,1181,0,18,15364
2023-06-22,4,8983,1746,3216,1073,0,18,15036
2023-06-22,5,8988,1993,2963,948,0,18,14910
2023-06-22,6,9003,2457,3353,781,13,18,15625
2023-06-22,7,9001,2810,3723,554,63,18,16169
2023-06-22,8,8995,3717,4119,247,136,18,17232
2023-06-22,9,9000,4197,4062,206,199,34,17698
2023-06-22,10,8730,4354,4387,195,291,74,18031
2023-06-22,11,8695,4472,4299,250,314,104,18134
2023-06-22,12,8690,3855,4253,526,355,75,17754
2023-06-22,13,8687,3628,4274,875,341,69,17874
2023-06-22,14,8712,4028,4463,1010,350,86,18649
2023-06-22,15,8783,4187,4566,980,324,121,18961
2023-06-22,16,8809,4670,4928,755,319,141,19622
2023-06-22,17,8960,4924,4850,598,197,146,19675
2023-06-22,18,9034,4819,4695,569,90,119,19326
2023-06-22,19,9210,4339,4716,595,32,125,19017
2023-06-22,20,9213,4613,4583,607,9,158,19183
2023-06-22,21,9209,4955,4389,685,0,185,19423
2023-06-22,22,9219,4446,3646,831,0,163,18305
2023-06-22,23,9221,3771,3439,715,0,123,17269
2023-06-22,24,9244,2852,3144,681,0,54,15975
2023-06-23,1,9263,2263,3038,594,0,18,15176
2023-06-23,2,9263,2370,2995,472,0,17,15117
2023-06-23,3,9261,2569,2916,375,0,17,15138
2023-06-23,4,9327,2758,2889,349,0,17,15340
2023-06-23,5,9330,2987,2644,204,1,17,15183
2023-06-23,6,9332,3233,3005,198,18,17,15803
2023-06-23,7,9340,3438,3495,140,60,17,16490
2023-06-23,8,9338,4204,3536,141,124,32,17375
2023-06-23,9,9332,4524,3748,83,167,62,17916
2023-06-23,10,9326,5117,4088,51,182,111,18875
2023-06-23,11,9322,5251,4191,49,212,130,19155
2023-06-23,12,9323,5563,4399,82,210,174,19751
2023-06-23,13,9324,5599,4106,91,191,118,19429
2023-06-23,14,9315,5496,4034,75,210,101,19231
2023-06-23,15,9317,5022,4196,48,188,74,18845
2023-06-23,16,9333,4961,4473,40,167,80,19054
2023-06-23,17,9363,4574,4848,50,102,81,19018
2023-06-23,18,9364,4563,4871,61,47,81,18987
2023-06-23,19,9362,4696,4878,43,23,109,19111
2023-06-23,20,9357,4662,4658,33,3,98,18811
2023-06-23,21,9362,4981,4414,50,0,133,18940
2023-06-23,22,9363,4256,3981,65,0,89,17754
2023-06-23,23,9367,3266,3558,48,0,69,16308
2023-06-23,24,9367,2703,3276,53,0,110,15509
2023-06-24,1,9373,2786,3087,58,0,42,15346
2023-06-24,2,9377,2248,3062,51,0,0,14738
2023-06-24,3,9384,2175,3006,43,0,0,14608
2023-06-24,4,9387,2127,2954,71,0,0,14539
2023-06-24,5,9387,2219,2751,97,0,0,14454
2023-06-24,6,9388,2345,2846,126,2,0,14707
2023-06-24,7,9381,2594,2728,92,29,0,14824
2023-06-24,8,9380,2601,3238,89,94,1,15403
2023-06-24,9,9376,3041,3567,45,169,23,16221
2023-06-24,10,9371,3835,3703,35,229,51,17224
2023-06-24,11,9371,4537,3797,65,282,75,18127
2023-06-24,12,9362,4624,3767,130,288,82,18253
2023-06-24,13,9365,4619,3685,294,267,77,18307
2023-06-24,14,9357,4738,3898,279,264,93,18629
2023-06-24,15,9346,4858,4167,323,285,126,19105
2023-06-24,16,9329,4862,4329,341,257,126,19244
2023-06-24,17,9337,4676,4678,306,171,110,19278
2023-06-24,18,9338,4698,4748,195,60,81,19120
2023-06-24,19,9341,4690,4547,129,30,87,18824
2023-06-24,20,9340,4781,4457,119,11,156,18864
2023-06-24,21,9347,4711,4201,176,0,164,18599
2023-06-24,22,9347,4472,3762,162,0,86,17829
2023-06-24,23,9353,3619,3306,141,0,26,16445
2023-06-24,24,9362,3114,3129,188,0,0,15793
2023-06-25,1,9370,2493,3115,311,0,0,15289
2023-06-25,2,9372,1833,2918,373,0,0,14496
2023-06-25,3,9373,1671,2813,425,0,0,14282
2023-06-25,4,9368,1673,2743,465,0,0,14249
2023-06-25,5,9372,1673,2761,458,0,0,14264
2023-06-25,6,9369,1826,3023,413,7,0,14638
2023-06-25,7,9363,2085,2910,255,52,0,14665
2023-06-25,8,9368,2428,3326,352,130,0,15604
2023-06-25,9,9373,3166,3554,352,234,0,16679
2023-06-25,10,9367,3980,3554,489,310,1,17701
2023-06-25,11,9361,4295,3520,931,359,23,18489
2023-06-25,12,9360,4293,3888,1113,336,53,19043
2023-06-25,13,9354,4455,4132,1067,351,61,19420
2023-06-25,14,9348,4581,4388,1045,353,83,19798
2023-06-25,15,9342,4591,4650,1056,330,85,20054
2023-06-25,16,9341,4635,5114,1027,263,72,20452
2023-06-25,17,9353,4683,4936,1180,189,79,20420
2023-06-25,18,9354,4593,4755,1441,90,103,20336
2023-06-25,19,9344,4471,4520,1665,30,75,20105
2023-06-25,20,9332,4037,4288,1842,2,62,19563
2023-06-25,21,9322,4410,3941,1759,0,61,19493
2023-06-25,22,9317,4473,3830,1248,0,71,18939
2023-06-25,23,9328,3974,3422,1089,0,47,17860
2023-06-25,24,9332,2848,3280,1208,0,0,16668
2023-06-26,1,9332,2282,3209,1263,0,13,16099
2023-06-26,2,9333,1946,3033,1344,0,17,15673
2023-06-26,3,9328,1917,3041,1188,0,17,15491
2023-06-26,4,9328,1937,2929,1065,0,17,15276
2023-06-26,5,9330,2321,2895,1088,1,19,15654
2023-06-26,6,9323,2577,3172,1229,4,37,16342
2023-06-26,7,9313,3045,3544,1165,39,27,17133
2023-06-26,8,9300,3888,3778,958,77,17,18018
2023-06-26,9,9301,4235,3594,1133,136,39,18438
2023-06-26,10,9305,4201,3628,1164,133,78,18509
2023-06-26,11,9313,4189,3711,1136,198,84,18631
2023-06-26,12,9301,4502,3822,1454,205,70,19354
2023-06-26,13,9306,4722,3827,1369,207,89,19520
2023-06-26,14,9311,4478,3876,1152,234,98,19149
2023-06-26,15,9308,4124,4160,994,225,81,18892
2023-06-26,16,9304,4245,4273,1048,142,87,19099
2023-06-26,17,9305,4535,4411,947,123,99,19420
2023-06-26,18,9305,4273,4377,1041,80,97,19173
2023-06-26,19,9303,4356,4354,932,21,103,19069
2023-06-26,20,9302,3917,4198,1192,2,110,18721
2023-06-26,21,9301,3951,4075,1146,0,116,18589
2023-06-26,22,9301,3631,3812,1171,0,102,18017
2023-06-26,23,9309,3273,3693,1086,0,98,17459
2023-06-26,24,9308,3031,3255,947,0,91,16632
2023-06-27,1,9303,2175,3257,910,0,36,15681
2023-06-27,2,9299,1907,3173,883,0,18,15280
2023-06-27,3,9293,1860,3051,876,0,18,15098
2023-06-27,4,9283,1984,3321,765,0,18,15371
2023-06-27,5,9287,2085,3430,631,0,18,15451
2023-06-27,6,9299,2308,3584,859,3,18,16071
2023-06-27,7,9312,2866,3789,1203,32,18,17220
2023-06-27,8,9316,3289,4118,1262,59,18,18062
2023-06-27,9,9317,3533,4065,1251,112,34,18312
2023-06-27,10,9312,3495,3973,1474,131,72,18457
2023-06-27,11,9310,3746,3924,1639,170,78,18867
2023-06-27,12,9310,4168,3911,1843,211,91,19534
2023-06-27,13,9315,4247,3812,1815,276,113,19578
2023-06-27,14,9314,4008,3726,2007,236,83,19374
2023-06-27,15,9315,3817,4068,2074,232,80,19586
2023-06-27,16,9317,3777,4156,2065,161,83,19559
2023-06-27,17,9312,3988,4503,2027,112,91,20033
2023-06-27,18,9311,4058,4247,2044,65,139,19864
2023-06-27,19,9310,3666,4169,2160,32,140,19477
2023-06-27,20,9319,3367,4160,2044,5,90,18985
2023-06-27,21,9332,3452,3988,1946,0,111,18829
2023-06-27,22,9334,3087,3621,1832,0,98,17972
2023-06-27,23,9340,2488,3255,1818,0,69,16970
2023-06-27,24,9348,1981,2610,1823,0,33,15795
2023-06-28,1,9349,1432,3033,1808,0,18,15640
2023-06-28,2,9361,1353,3003,1919,0,18,15654
2023-06-28,3,9364,1600,2798,1579,0,18,15359
2023-06-28,4,9369,1910,2926,1372,0,18,15595
2023-06-28,5,9379,2136,3580,662,0,19,15776
2023-06-28,6,9386,2364,3617,519,7,40,15933
2023-06-28,7,9388,2695,3862,697,44,45,16731
2023-06-28,8,9396,3353,3841,584,109,44,17327
2023-06-28,9,9401,3482,3892,496,180,29,17480
2023-06-28,10,9412,3736,3592,593,228,36,17597
2023-06-28,11,9425,3805,3344,769,260,43,17646
2023-06-28,12,9429,3665,3703,787,282,39,17905
2023-06-28,13,9434,3884,3817,722,307,43,18207
2023-06-28,14,9431,4490,4047,655,292,42,18957
2023-06-28,15,9414,4468,4467,530,274,48,19201
2023-06-28,16,9396,4895,4758,495,250,63,19857
2023-06-28,17,9393,4874,4907,420,215,83,19892
2023-06-28,18,9384,4665,4844,312,130,84,19419
2023-06-28,19,9383,4734,4677,219,41,84,19138
2023-06-28,20,9391,4540,4556,210,8,106,18811
2023-06-28,21,9388,4495,4415,231,0,93,18622
2023-06-28,22,9406,4320,3873,186,0,93,17878
2023-06-28,23,9422,3480,3545,159,0,71,16677
2023-06-28,24,9419,2582,3093,152,0,35,15281
2023-06-29,1,9421,2126,2961,145,0,18,14671
2023-06-29,2,9430,1829,3120,134,0,18,14531
2023-06-29,3,9481,1927,2944,140,0,18,14510
2023-06-29,4,9490,2099,2887,195,0,18,14689
2023-06-29,5,9337,2395,3417,97,0,18,15264
2023-06-29,6,9203,2462,3653,239,15,21,15593
2023-06-29,7,9200,2626,3809,402,64,19,16120
2023-06-29,8,9417,2922,3750,302,152,18,16561
2023-06-29,9,9435,3569,3710,237,240,18,17209
2023-06-29,10,9424,3856,3605,535,326,19,17765
2023-06-29,11,9366,3968,3720,714,364,19,18151
2023-06-29,12,8911,4514,4078,412,393,19,18327
2023-06-29,13,8898,4698,4186,467,395,19,18663
2023-06-29,14,8907,4793,4040,479,368,35,18622
2023-06-29,15,8929,4366,4145,527,330,75,18372
2023-06-29,16,8941,3904,4667,529,285,88,18414
2023-06-29,17,8943,4256,4940,669,209,100,19117
2023-06-29,18,8950,3678,5101,794,104,102,18729
2023-06-29,19,8949,3864,5070,1079,35,116,19113
2023-06-29,20,8953,3635,4811,1278,7,107,18791
2023-06-29,21,8950,3054,4627,1552,0,107,18290
2023-06-29,22,8945,3333,4106,1680,0,105,18169
2023-06-29,23,8953,2702,3637,1647,0,76,17015
2023-06-29,24,8952,2402,3385,1591,0,25,16355
2023-06-30,1,8953,2041,3472,1467,0,17,15950
2023-06-30,2,8944,1876,3170,1596,0,17,15603
2023-06-30,3,8932,2077,2929,1285,0,17,15240
2023-06-30,4,8923,2312,2966,1221,0,17,15439
2023-06-30,5,8922,2829,2904,899,0,17,15571
2023-06-30,6,8922,2944,2907,749,5,18,15545
2023-06-30,7,8920,2975,3353,753,35,18,16054
2023-06-30,8,8905,3515,4151,661,89,18,17339
2023-06-30,9,8895,4525,4033,411,135,18,18017
2023-06-30,10,8909,4853,4319,389,171,18,18659
2023-06-30,11,8911,4473,4304,441,238,18,18385
2023-06-30,12,8910,4813,4398,486,267,18,18892
2023-06-30,13,8888,4863,4464,547,339,18,19119
2023-06-30,14,8857,4918,4692,586,315,18,19386
2023-06-30,15,8842,4999,4865,497,292,23,19518
2023-06-30,16,8839,5212,5109,472,275,47,19954
2023-06-30,17,8840,5549,5042,563,176,80,20250
2023-06-30,18,8840,5301,5068,414,100,85,19808
2023-06-30,19,8843,5200,5000,323,34,85,19485
2023-06-30,20,8835,5024,4907,313,7,85,19171
2023-06-30,21,8840,4731,4598,420,0,86,18675
2023-06-30,22,8841,4598,4213,542,0,58,18252
2023-06-30,23,8839,3829,3786,819,0,18,17291
2023-06-30,24,8830,2859,3396,1013,0,18,16116
2023-07-01,1,8828,2789,3050,1053,0,18,15738
2023-07-01,2,8825,2477,2930,1270,0,18,15520
2023-07-01,3,8821,1972,2798,1293,0,18,14902
2023-07-01,4,8830,2016,2913,1013,0,18,14790
2023-07-01,5,8830,2226,2864,820,0,18,14758
2023-07-01,6,8835,2365,3027,568,5,18,14818
2023-07-01,7,8839,2535,3087,383,44,26,14914
2023-07-01,8,8835,3072,3321,369,123,31,15751
2023-07-01,9,8836,3420,3689,283,221,31,16480
2023-07-01,10,8831,4372,3892,230,295,36,17656
2023-07-01,11,8822,4965,4172,213,326,46,18544
2023-07-01,12,8810,5248,4558,228,337,43,19224
2023-07-01,13,8815,5367,4320,223,287,37,19049
2023-07-01,14,8813,5392,4428,300,215,40,19188
2023-07-01,15,8810,4912,4384,288,196,66,18656
2023-07-01,16,8805,4541,4662,209,128,98,18443
2023-07-01,17,8801,4797,4665,170,94,98,18625
2023-07-01,18,8797,5005,4533,119,82,98,18634
2023-07-01,19,8796,4507,4469,235,41,89,18137
2023-07-01,20,8796,4571,4290,234,7,85,17983
2023-07-01,21,8792,5024,4134,238,0,39,18227
2023-07-01,22,8805,5203,3739,256,0,31,18034
2023-07-01,23,8808,4630,3553,353,0,31,17375
2023-07-01,24,8812,3770,3417,365,0,31,16395
2023-07-02,1,8820,3202,3385,283,0,22,15712
2023-07-02,2,8817,2598,3224,257,0,18,14914
2023-07-02,3,8810,2183,3275,157,0,18,14443
2023-07-02,4,8806,2209,3331,126,0,18,14490
2023-07-02,5,8799,2318,2927,156,0,18,14218
2023-07-02,6,8796,2574,2973,204,4,17,14568
2023-07-02,7,8793,2774,2907,294,30,26,14824
2023-07-02,8,8793,3003,2911,368,57,31,15163
2023-07-02,9,8794,3168,3474,389,106,31,15962
2023-07-02,10,8786,3825,3589,232,150,31,16613
2023-07-02,11,8788,4235,3647,201,128,31,17030
2023-07-02,12,8781,4664,3686,192,162,31,17516
2023-07-02,13,8787,4451,4007,165,188,31,17629
2023-07-02,14,8786,4641,4135,196,177,31,17966
2023-07-02,15,8777,4678,4348,251,146,53,18253
2023-07-02,16,8762,4596,4967,204,142,82,18753
2023-07-02,17,8772,5001,5151,106,104,84,19218
2023-07-02,18,8777,5050,5173,87,66,85,19238
2023-07-02,19,8782,5072,5138,97,33,85,19207
2023-07-02,20,8772,5114,4925,111,5,68,18995
2023-07-02,21,8775,5120,4560,147,0,33,18635
2023-07-02,22,8769,5049,3925,167,0,36,17946
2023-07-02,23,8773,4609,3390,175,0,40,16987
2023-07-02,24,8776,3700,3276,164,0,43,15959
2023-07-03,1,8788,3163,3185,140,0,35,15311
2023-07-03,2,8785,2936,3070,115,0,35,14941
2023-07-03,3,8785,2675,3031,138,0,31,14660
2023-07-03,4,8786,2762,2848,160,0,30,14586
2023-07-03,5,8804,2752,2765,183,0,32,14536
2023-07-03,6,8819,2824,2796,146,4,33,14622
2023-07-03,7,8814,2782,2938,96,28,37,14695
2023-07-03,8,8802,3050,3460,85,63,45,15505
2023-07-03,9,8791,3456,3860,64,125,38,16334
2023-07-03,10,8787,4234,3769,73,169,51,17083
2023-07-03,11,8787,4816,3790,127,192,64,17776
2023-07-03,12,8775,5088,4253,184,248,70,18618
2023-07-03,13,8767,5363,4368,198,293,72,19061
2023-07-03,14,8765,5443,4467,342,270,72,19359
2023-07-03,15,8766,5283,4921,434,273,72,19749
2023-07-03,16,8768,4909,5243,475,268,73,19736
2023-07-03,17,8769,5103,5612,481,170,77,20212
2023-07-03,18,8772,5388,5540,512,119,113,20444
2023-07-03,19,8783,5317,5437,499,38,126,20200
2023-07-03,20,8793,5277,5101,410,8,127,19716
2023-07-03,21,8805,5396,4627,395,0,114,19337
2023-07-03,22,8817,5201,4036,376,0,116,18546
2023-07-03,23,8822,4751,3615,267,0,82,17537
2023-07-03,24,8821,3874,3049,196,0,74,16014
2023-07-04,1,8819,3532,3059,126,0,63,15599
2023-07-04,2,8814,3246,2892,50,0,58,15060
2023-07-04,3,8813,3232,2880,52,0,59,15036
2023-07-04,4,8809,3281,2761,72,0,62,14985
2023-07-04,5,8800,3355,2516,14,0,62,14747
2023-07-04,6,8806,3481,2710,36,5,61,15099
2023-07-04,7,8798,3722,3680,106,52,69,16427
2023-07-04,8,8790,4592,3956,29,145,75,17587
2023-07-04,9,8793,5362,4142,7,259,64,18627
2023-07-04,10,8811,5720,4327,11,351,61,19281
2023-07-04,11,8809,5906,4526,45,391,67,19744
2023-07-04,12,8808,5938,4736,91,371,76,20020
2023-07-04,13,8801,5927,4833,152,386,110,20209
2023-07-04,14,8810,5939,4956,248,382,119,20454
2023-07-04,15,8559,5930,5007,334,346,115,20291
2023-07-04,16,8210,6067,5310,428,261,126,20402
2023-07-04,17,8276,5926,5276,468,148,115,20209
2023-07-04,18,8343,5518,5103,451,124,112,19651
2023-07-04,19,8356,5898,5279,334,35,113,20015
2023-07-04,20,8359,6133,5241,305,7,142,20187
2023-07-04,21,8355,6159,5104,306,0,123,20047
2023-07-04,22,8343,6129,4753,362,0,123,19710
2023-07-04,23,8342,5628,3678,522,0,125,18295
2023-07-04,24,8336,5118,2989,532,0,131,17106
2023-07-05,1,8339,4711,2846,575,0,123,16594
2023-07-05,2,8337,3813,2783,693,0,114,15740
2023-07-05,3,8347,3694,2568,767,0,115,15491
2023-07-05,4,8344,3761,2444,665,0,114,15328
2023-07-05,5,8355,3819,2526,522,0,115,15337
2023-07-05,6,8369,3851,2878,529,7,116,15750
2023-07-05,7,8383,4571,3557,471,52,122,17156
2023-07-05,8,8378,5536,3536,233,156,128,17967
2023-07-05,9,8366,6145,4058,121,262,112,19064
2023-07-05,10,8376,6277,4228,168,344,117,19510
2023-07-05,11,8363,6339,5146,90,391,113,20442
2023-07-05,12,8346,6363,4996,161,404,117,20387
2023-07-05,13,8317,6255,4920,287,380,117,20276
2023-07-05,14,8311,6352,5124,374,363,117,20641
2023-07-05,15,8297,6569,5246,504,315,116,21047
2023-07-05,16,8287,6688,5163,706,277,119,21240
2023-07-05,17,8291,6707,5300,604,210,116,21228
2023-07-05,18,8308,6814,5557,401,109,119,21308
2023-07-05,19,8323,6905,5432,316,31,122,21129
2023-07-05,20,8337,6684,5122,404,6,122,20675
2023-07-05,21,8337,6489,4932,573,0,122,20453
2023-07-05,22,8347,6183,4641,710,0,117,19998
2023-07-05,23,8353,5259,4398,776,0,67,18853
2023-07-05,24,8359,5277,3631,792,0,50,18109
2023-07-06,1,8410,5126,3172,729,0,46,17483
2023-07-06,2,8472,4532,3170,704,0,42,16920
2023-07-06,3,8475,4285,3109,530,0,43,16442
2023-07-06,4,8480,4175,3059,477,0,44,16235
2023-07-06,5,8480,4338,3142,480,0,44,16484
2023-07-06,6,8483,4358,3769,447,7,43,17107
2023-07-06,7,8487,5036,3918,332,45,49,17867
2023-07-06,8,8485,6039,3913,203,131,73,18844
2023-07-06,9,8476,6255,4163,414,212,104,19624
2023-07-06,10,8484,6303,4323,529,263,109,20011
2023-07-06,11,8501,6571,4678,453,292,109,20604
2023-07-06,12,8585,6519,4879,499,306,107,20895
2023-07-06,13,8631,6412,4881,459,322,113,20818
2023-07-06,14,8643,6220,4596,389,323,112,20283
2023-07-06,15,8643,5730,4796,406,273,110,19958
2023-07-06,16,8636,6202,5467,212,267,110,20894
2023-07-06,17,8666,6426,5739,180,136,109,21256
2023-07-06,18,8690,6088,5454,364,64,106,20766
2023-07-06,19,8705,6056,5282,424,34,107,20608
2023-07-06,20,8884,6142,5150,569,7,105,20857
2023-07-06,21,8890,6122,5043,433,0,111,20599
2023-07-06,22,8971,5972,4951,406,0,66,20366
2023-07-06,23,9100,4805,4554,593,0,55,19107
2023-07-06,24,9077,4449,3688,585,0,55,17854
2023-07-07,1,9076,4343,3093,813,0,47,17372
2023-07-07,2,9228,3954,3033,993,0,43,17251
2023-07-07,3,9273,3238,3202,1142,0,43,16898
2023-07-07,4,9282,2949,2935,1138,0,45,16349
2023-07-07,5,9277,3106,3221,1034,0,44,16682
2023-07-07,6,9290,3161,3427,911,6,43,16838
2023-07-07,7,9301,3690,3840,739,48,50,17668
2023-07-07,8,9316,4081,4048,606,128,67,18246
2023-07-07,9,9334,4292,4204,554,183,65,18632
2023-07-07,10,9342,4611,4271,552,249,73,19098
2023-07-07,11,9353,4582,4437,497,296,73,19238
2023-07-07,12,9362,5191,4392,438,300,90,19773
2023-07-07,13,9374,5464,4462,488,333,123,20244
2023-07-07,14,9322,5449,4474,533,331,128,20237
2023-07-07,15,9388,5812,4667,499,330,125,20821
2023-07-07,16,9395,5569,4830,466,278,129,20667
2023-07-07,17,9403,5505,4932,420,203,130,20593
2023-07-07,18,9380,5740,5044,324,114,129,20731
2023-07-07,19,9352,5894,5074,246,33,128,20727
2023-07-07,20,9318,5986,4492,234,6,126,20162
2023-07-07,21,9312,5199,4248,298,0,78,19135
2023-07-07,22,9313,4582,4148,383,0,61,18487
2023-07-07,23,9335,3986,4004,481,0,70,17876
2023-07-07,24,9355,3620,3720,541,0,74,17310
2023-07-08,1,9372,2992,3635,520,0,65,16584
2023-07-08,2,9388,2452,3494,412,0,61,15807
2023-07-08,3,9411,2248,3332,449,0,59,15499
2023-07-08,4,9414,2157,3207,552,0,59,15389
2023-07-08,5,9429,2225,3120,662,0,59,15495
2023-07-08,6,9427,2410,3180,626,11,60,15714
2023-07-08,7,9406,2532,3557,505,54,67,16121
2023-07-08,8,9388,2705,3522,340,132,73,16160
2023-07-08,9,9373,2930,3750,305,217,63,16638
2023-07-08,10,9361,3570,3871,344,272,68,17486
2023-07-08,11,9346,4226,3862,450,278,69,18231
2023-07-08,12,9350,4461,3984,463,294,71,18623
2023-07-08,13,9340,4624,4008,331,285,70,18658
2023-07-08,14,9335,4671,3970,409,235,72,18692
2023-07-08,15,9340,4377,4472,433,211,71,18904
2023-07-08,16,9338,4257,4898,449,180,72,19194
2023-07-08,17,9366,4286,5136,513,140,71,19512
2023-07-08,18,9433,3812,5307,371,94,72,19089
2023-07-08,19,9558,4228,5062,284,31,73,19236
2023-07-08,20,9578,4080,4901,244,5,74,18882
2023-07-08,21,9607,4397,4212,328,0,68,18612
2023-07-08,22,9635,3645,4085,237,0,69,17671
2023-07-08,23,9642,3131,4085,269,0,76,17203
2023-07-08,24,9647,3063,3779,251,0,74,16814
2023-07-09,1,9648,1982,3829,238,0,68,15765
2023-07-09,2,9616,1619,3604,281,0,61,15181
2023-07-09,3,9634,1310,3399,329,0,60,14732
2023-07-09,4,9644,1013,3336,361,0,60,14414
2023-07-09,5,9633,905,3100,382,0,61,14081
2023-07-09,6,9628,1071,3135,375,4,60,14273
2023-07-09,7,9621,1432,3249,248,29,67,14646
2023-07-09,8,9606,2149,3378,132,63,72,15400
2023-07-09,9,9597,3046,3650,91,111,56,16551
2023-07-09,10,9589,3360,3585,117,185,63,16899
2023-07-09,11,9596,3665,3783,181,194,65,17484
2023-07-09,12,9609,3859,3638,438,180,66,17790
2023-07-09,13,9605,4041,3881,587,220,65,18399
2023-07-09,14,9594,4246,4089,562,244,64,18799
2023-07-09,15,9595,4557,4440,673,204,65,19534
2023-07-09,16,9614,4499,4797,800,173,65,19948
2023-07-09,17,9653,4834,5094,670,96,65,20412
2023-07-09,18,9687,5115,5316,528,57,68,20771
2023-07-09,19,9664,5239,5368,332,31,69,20703
2023-07-09,20,9646,4936,4650,260,6,69,19567
2023-07-09,21,9630,4788,4324,265,0,60,19067
2023-07-09,22,9563,4564,4047,275,0,66,18515
2023-07-09,23,9625,3894,3448,263,0,74,17304
2023-07-09,24,9620,3267,3192,303,0,74,16456
2023-07-10,1,9628,2703,2935,322,0,66,15654
2023-07-10,2,9626,2230,2902,309,0,60,15127
2023-07-10,3,9630,2132,2829,306,0,59,14956
2023-07-10,4,9599,2177,2799,270,0,59,14904
2023-07-10,5,9588,2263,2813,413,0,59,15136
2023-07-10,6,9591,2344,3193,552,3,59,15742
2023-07-10,7,9598,2958,3148,577,31,68,16380
2023-07-10,8,9630,3374,3385,427,108,73,16997
2023-07-10,9,9643,4687,3589,365,195,58,18537
2023-07-10,10,9633,5010,3623,365,280,66,18977
2023-07-10,11,9612,4915,3679,460,311,74,19051
2023-07-10,12,9598,5082,3956,550,303,74,19563
2023-07-10,13,9564,5244,3972,703,273,74,19830
2023-07-10,14,9545,5248,4112,816,299,74,20094
2023-07-10,15,9414,5470,4509,987,298,70,20748
2023-07-10,16,9520,5565,4951,1148,242,69,21495
2023-07-10,17,9514,5523,5215,1315,189,64,21820
2023-07-10,18,9536,5710,5180,1251,110,63,21850
2023-07-10,19,9542,5716,5108,1141,45,66,21618
2023-07-10,20,9543,5619,4986,1161,9,66,21384
2023-07-10,21,9529,5180,4566,1446,0,66,20787
2023-07-10,22,9620,4416,4354,1777,0,57,20224
2023-07-10,23,9779,3429,3543,2035,0,67,18853
2023-07-10,24,9429,2904,3297,1969,0,73,17672
2023-07-11,1,9706,1869,2786,1931,0,66,16358
2023-07-11,2,9790,1653,3077,1842,0,62,16424
2023-07-11,3,9821,1654,2752,1801,0,62,16090
2023-07-11,4,9815,1653,2973,1688,0,62,16191
2023-07-11,5,9806,1737,3194,1403,0,61,16201
2023-07-11,6,9794,1967,3141,1408,6,60,16376
2023-07-11,7,9789,2525,3287,1168,46,70,16885
2023-07-11,8,9788,3145,3798,837,144,72,17784
2023-07-11,9,9775,4300,3789,910,255,58,19087
2023-07-11,10,9771,4369,4006,1226,347,58,19777
2023-07-11,11,9756,4292,4181,1629,384,71,20313
2023-07-11,12,9748,4716,4294,1773,381,75,20987
2023-07-11,13,9764,4699,4345,2022,391,72,21293
2023-07-11,14,9775,4517,4471,2205,363,66,21397
2023-07-11,15,9788,4535,4532,2492,344,66,21757
2023-07-11,16,9779,4406,4728,2302,263,72,21550
2023-07-11,17,9786,4157,4916,2155,135,92,21241
2023-07-11,18,9801,4192,4979,1527,69,122,20690
2023-07-11,19,9820,4655,5081,1248,20,113,20937
2023-07-11,20,9825,4783,5019,861,4,115,20607
2023-07-11,21,9844,5179,4736,843,0,115,20717
2023-07-11,22,9845,4524,4211,845,0,122,19547
2023-07-11,23,9848,3774,3920,789,0,83,18414
2023-07-11,24,9855,2526,3773,635,0,64,16853
2023-07-12,1,9869,1723,3440,634,0,49,15715
2023-07-12,2,9939,1614,3034,715,0,56,15358
2023-07-12,3,10066,1698,3065,776,0,58,15663
2023-07-12,4,10077,1821,3006,881,0,58,15843
2023-07-12,5,10083,2123,2700,633,0,57,15596
2023-07-12,6,10083,2653,2704,444,9,58,15951
2023-07-12,7,10088,2904,3330,456,60,61,16899
2023-07-12,8,10093,2929,3822,267,125,66,17302
2023-07-12,9,10102,3244,3989,159,190,60,17744
2023-07-12,10,10097,3271,4185,123,242,64,17982
2023-07-12,11,10099,3662,4257,148,258,70,18494
2023-07-12,12,10077,3747,4383,154,299,72,18732
2023-07-12,13,10071,4265,4661,201,337,69,19604
2023-07-12,14,10062,4718,4855,189,336,64,20224
2023-07-12,15,10053,4950,4889,130,288,61,20371
2023-07-12,16,10085,5041,5311,79,233,57,20806
2023-07-12,17,10063,5492,5240,90,136,53,21074
2023-07-12,18,10157,4876,5003,67,43,56,20202
2023-07-12,19,10162,4536,5087,95,24,54,19958
2023-07-12,20,10167,4285,4796,228,3,62,19541
2023-07-12,21,10163,4220,4561,410,0,57,19411
2023-07-12,22,10172,3409,4177,723,0,56,18537
2023-07-12,23,10212,2898,3690,859,0,64,17723
2023-07-12,24,10234,1899,3512,891,0,71,16607
